,Unnamed: 0,Player,Span,Mat,Inns,Dis,Ct,St,Ct Wk,Ct Fi,MD,D/I
0,0,KC Sangakkara (Asia/ICC/SL),2000-2015,404,397,501,402,99,383,19,5 (4ct 1st),1.261
1,1,AC Gilchrist (AUS/ICC),1996-2008,287,286,472,417,55,417,0,6 (6ct 0st),1.65
2,2,MS Dhoni (Asia/INDIA),2004-2019,350,345,444,321,123,321,0,6 (5ct 1st),1.286
3,3,MV Boucher (Afr/SA),1998-2011,295,291,425,403,22,402,1,6 (6ct 0st),1.46
4,4,Moin Khan (PAK),1990-2004,219,217,287,214,73,214,0,5 (5ct 0st),1.3219999999999998
5,5,BB McCullum (NZ),2002-2016,260,257,277,262,15,227,35,5 (5ct 0st),1.077
6,6,IA Healy (AUS),1988-1997,168,168,233,194,39,194,0,4 (4ct 0st),1.386
7,7,Mushfiqur Rahim (BDESH),2006-2019,216,215,225,181,44,179,2,5 (5ct 0st),1.046
8,8,Rashid Latif (PAK),1992-2003,166,164,220,182,38,182,0,5 (5ct 0st),1.341
9,9,DPMD Jayawardene (Asia/SL),1998-2015,448,443,218,218,0,0,218,4 (4ct 0st),0.492
10,10,R Dravid (Asia/ICC/INDIA),1996-2011,344,341,210,196,14,72,124,4 (4ct 0st),0.615
11,11,RS Kaluwitharana (SL),1990-2004,189,188,207,132,75,131,1,5 (4ct 1st),1.101
12,12,PJL Dujon (WI),1981-1991,169,168,204,183,21,183,0,4 (4ct 0st),1.214
13,13,JC Buttler (ENG),2012-2019,142,138,202,171,31,171,0,6 (6ct 0st),1.463
14,14,RD Jacobs (WI),1996-2004,147,145,189,160,29,160,0,6 (5ct 1st),1.3030000000000002
15,15,Kamran Akmal (PAK),2002-2017,157,154,188,157,31,156,1,5 (4ct 1st),1.22
16,16,D Ramdin (WI),2005-2016,139,137,188,181,7,181,0,5 (5ct 0st),1.372
17,17,AB de Villiers (Afr/SA),2005-2018,228,223,181,176,5,93,83,5 (5ct 0st),0.8109999999999999
18,18,BJ Haddin (AUS),2001-2015,126,124,181,170,11,170,0,5 (5ct 0st),1.459
19,19,AJ Stewart (ENG),1989-2003,170,169,174,159,15,148,11,6 (6ct 0st),1.029
20,20,A Flower (ZIM),1992-2003,213,212,173,141,32,133,8,5 (5ct 0st),0.816
21,21,Q de Kock (SA),2013-2019,115,111,166,158,8,158,0,6 (5ct 1st),1.495
22,22,DJ Richardson (SA),1991-1998,122,121,165,148,17,148,0,5 (5ct 0st),1.3630000000000002
23,23,RT Ponting (AUS/ICC),1995-2012,375,372,160,160,0,0,160,3 (3ct 0st),0.43
24,24,M Azharuddin (INDIA),1985-2000,334,332,156,156,0,0,156,4 (4ct 0st),0.469
25,25,NR Mongia (INDIA),1994-2000,140,139,154,110,44,110,0,5 (4ct 1st),1.107
26,26,BRM Taylor (ZIM),2004-2019,193,193,154,125,29,96,29,5 (5ct 0st),0.797
27,27,T Taibu (Afr/ZIM),2001-2012,150,150,147,114,33,112,2,4 (4ct 0st),0.98
28,28,AC Parore (NZ),1992-2002,179,178,141,116,25,111,5,5 (3ct 2st),0.792
29,29,Sarfaraz Ahmed (PAK),2007-2019,116,114,140,116,24,116,0,6 (6ct 0st),1.228
30,30,SR Tendulkar (INDIA),1989-2012,463,456,140,140,0,0,140,4 (4ct 0st),0.307
31,31,LRPL Taylor (NZ),2006-2019,228,224,137,137,0,0,137,4 (4ct 0st),0.611
32,32,Younis Khan (PAK),2000-2015,265,260,135,135,0,5,130,4 (4ct 0st),0.519
33,33,SP Fleming (ICC/NZ),1994-2007,280,276,133,133,0,0,133,4 (4ct 0st),0.481
34,34,JH Kallis (Afr/ICC/SA),1996-2014,328,324,131,131,0,0,131,3 (3ct 0st),0.4039999999999999
35,35,M Muralitharan (Asia/ICC/SL),1993-2011,350,347,130,130,0,0,130,3 (3ct 0st),0.374
36,36,AR Border (AUS),1979-1994,273,270,127,127,0,0,127,3 (3ct 0st),0.47
37,37,Shahid Afridi (Asia/ICC/PAK),1996-2015,398,392,127,127,0,0,127,2 (2ct 0st),0.3229999999999999
38,38,Khaled Mashud (BDESH),1995-2006,126,126,126,91,35,91,0,5 (3ct 2st),1.0
39,39,TM Dilshan (SL),1999-2016,330,325,124,123,1,5,118,3 (3ct 0st),0.381
40,40,CH Gayle (ICC/WI),1999-2019,301,294,124,124,0,0,124,3 (3ct 0st),0.421
41,41,V Kohli (INDIA),2008-2019,242,240,124,124,0,0,124,3 (3ct 0st),0.516
42,42,RW Marsh (AUS),1971-1984,92,92,124,120,4,120,0,5 (5ct 0st),1.347
43,43,ST Jayasuriya (Asia/SL),1989-2011,445,441,123,123,0,0,123,3 (3ct 0st),0.278
44,44,CL Hooper (WI),1987-2003,227,225,120,120,0,0,120,4 (4ct 0st),0.5329999999999999
45,45,BC Lara (ICC/WI),1990-2007,299,296,120,120,0,0,120,3 (3ct 0st),0.405
46,46,L Ronchi (AUS/NZ),2008-2017,85,83,117,105,12,105,0,4 (4ct 0st),1.409
47,47,MS Wade (AUS),2012-2017,94,94,117,108,9,108,0,5 (5ct 0st),1.244
48,48,Inzamam-ul-Haq (Asia/PAK),1991-2007,378,373,113,113,0,0,113,3 (3ct 0st),0.302
49,49,SR Waugh (AUS),1986-2002,325,324,111,111,0,0,111,3 (3ct 0st),0.342
50,0,KC Sangakkara (Asia/ICC/SL),2000-2015,404,397,501,402,99,383,19,5 (4ct 1st),1.261
51,1,AC Gilchrist (AUS/ICC),1996-2008,287,286,472,417,55,417,0,6 (6ct 0st),1.65
52,2,MS Dhoni (Asia/INDIA),2004-2019,350,345,444,321,123,321,0,6 (5ct 1st),1.286
53,3,MV Boucher (Afr/SA),1998-2011,295,291,425,403,22,402,1,6 (6ct 0st),1.46
54,4,Moin Khan (PAK),1990-2004,219,217,287,214,73,214,0,5 (5ct 0st),1.3219999999999998
55,5,BB McCullum (NZ),2002-2016,260,257,277,262,15,227,35,5 (5ct 0st),1.077
56,6,IA Healy (AUS),1988-1997,168,168,233,194,39,194,0,4 (4ct 0st),1.386
57,7,Mushfiqur Rahim (BDESH),2006-2019,216,215,225,181,44,179,2,5 (5ct 0st),1.046
58,8,Rashid Latif (PAK),1992-2003,166,164,220,182,38,182,0,5 (5ct 0st),1.341
59,9,DPMD Jayawardene (Asia/SL),1998-2015,448,443,218,218,0,0,218,4 (4ct 0st),0.492
60,10,R Dravid (Asia/ICC/INDIA),1996-2011,344,341,210,196,14,72,124,4 (4ct 0st),0.615
61,11,RS Kaluwitharana (SL),1990-2004,189,188,207,132,75,131,1,5 (4ct 1st),1.101
62,12,PJL Dujon (WI),1981-1991,169,168,204,183,21,183,0,4 (4ct 0st),1.214
63,13,JC Buttler (ENG),2012-2019,142,138,202,171,31,171,0,6 (6ct 0st),1.463
64,14,RD Jacobs (WI),1996-2004,147,145,189,160,29,160,0,6 (5ct 1st),1.3030000000000002
65,15,Kamran Akmal (PAK),2002-2017,157,154,188,157,31,156,1,5 (4ct 1st),1.22
66,16,D Ramdin (WI),2005-2016,139,137,188,181,7,181,0,5 (5ct 0st),1.372
67,17,AB de Villiers (Afr/SA),2005-2018,228,223,181,176,5,93,83,5 (5ct 0st),0.8109999999999999
68,18,BJ Haddin (AUS),2001-2015,126,124,181,170,11,170,0,5 (5ct 0st),1.459
69,19,AJ Stewart (ENG),1989-2003,170,169,174,159,15,148,11,6 (6ct 0st),1.029
70,20,A Flower (ZIM),1992-2003,213,212,173,141,32,133,8,5 (5ct 0st),0.816
71,21,Q de Kock (SA),2013-2019,115,111,166,158,8,158,0,6 (5ct 1st),1.495
72,22,DJ Richardson (SA),1991-1998,122,121,165,148,17,148,0,5 (5ct 0st),1.3630000000000002
73,23,RT Ponting (AUS/ICC),1995-2012,375,372,160,160,0,0,160,3 (3ct 0st),0.43
74,24,M Azharuddin (INDIA),1985-2000,334,332,156,156,0,0,156,4 (4ct 0st),0.469
75,25,NR Mongia (INDIA),1994-2000,140,139,154,110,44,110,0,5 (4ct 1st),1.107
76,26,BRM Taylor (ZIM),2004-2019,193,193,154,125,29,96,29,5 (5ct 0st),0.797
77,27,T Taibu (Afr/ZIM),2001-2012,150,150,147,114,33,112,2,4 (4ct 0st),0.98
78,28,AC Parore (NZ),1992-2002,179,178,141,116,25,111,5,5 (3ct 2st),0.792
79,29,Sarfaraz Ahmed (PAK),2007-2019,116,114,140,116,24,116,0,6 (6ct 0st),1.228
80,30,SR Tendulkar (INDIA),1989-2012,463,456,140,140,0,0,140,4 (4ct 0st),0.307
81,31,LRPL Taylor (NZ),2006-2019,228,224,137,137,0,0,137,4 (4ct 0st),0.611
82,32,Younis Khan (PAK),2000-2015,265,260,135,135,0,5,130,4 (4ct 0st),0.519
83,33,SP Fleming (ICC/NZ),1994-2007,280,276,133,133,0,0,133,4 (4ct 0st),0.481
84,34,JH Kallis (Afr/ICC/SA),1996-2014,328,324,131,131,0,0,131,3 (3ct 0st),0.4039999999999999
85,35,M Muralitharan (Asia/ICC/SL),1993-2011,350,347,130,130,0,0,130,3 (3ct 0st),0.374
86,36,AR Border (AUS),1979-1994,273,270,127,127,0,0,127,3 (3ct 0st),0.47
87,37,Shahid Afridi (Asia/ICC/PAK),1996-2015,398,392,127,127,0,0,127,2 (2ct 0st),0.3229999999999999
88,38,Khaled Mashud (BDESH),1995-2006,126,126,126,91,35,91,0,5 (3ct 2st),1.0
89,39,TM Dilshan (SL),1999-2016,330,325,124,123,1,5,118,3 (3ct 0st),0.381
90,40,CH Gayle (ICC/WI),1999-2019,301,294,124,124,0,0,124,3 (3ct 0st),0.421
91,41,V Kohli (INDIA),2008-2019,242,240,124,124,0,0,124,3 (3ct 0st),0.516
92,42,RW Marsh (AUS),1971-1984,92,92,124,120,4,120,0,5 (5ct 0st),1.347
93,43,ST Jayasuriya (Asia/SL),1989-2011,445,441,123,123,0,0,123,3 (3ct 0st),0.278
94,44,CL Hooper (WI),1987-2003,227,225,120,120,0,0,120,4 (4ct 0st),0.5329999999999999
95,45,BC Lara (ICC/WI),1990-2007,299,296,120,120,0,0,120,3 (3ct 0st),0.405
96,46,L Ronchi (AUS/NZ),2008-2017,85,83,117,105,12,105,0,4 (4ct 0st),1.409
97,47,MS Wade (AUS),2012-2017,94,94,117,108,9,108,0,5 (5ct 0st),1.244
98,48,Inzamam-ul-Haq (Asia/PAK),1991-2007,378,373,113,113,0,0,113,3 (3ct 0st),0.302
99,49,SR Waugh (AUS),1986-2002,325,324,111,111,0,0,111,3 (3ct 0st),0.342
100,0,KC Sangakkara (Asia/ICC/SL),2000-2015,404,397,501,402,99,383,19,5 (4ct 1st),1.261
101,1,AC Gilchrist (AUS/ICC),1996-2008,287,286,472,417,55,417,0,6 (6ct 0st),1.65
102,2,MS Dhoni (Asia/INDIA),2004-2019,350,345,444,321,123,321,0,6 (5ct 1st),1.286
103,3,MV Boucher (Afr/SA),1998-2011,295,291,425,403,22,402,1,6 (6ct 0st),1.46
104,4,Moin Khan (PAK),1990-2004,219,217,287,214,73,214,0,5 (5ct 0st),1.3219999999999998
105,5,BB McCullum (NZ),2002-2016,260,257,277,262,15,227,35,5 (5ct 0st),1.077
106,6,IA Healy (AUS),1988-1997,168,168,233,194,39,194,0,4 (4ct 0st),1.386
107,7,Mushfiqur Rahim (BDESH),2006-2019,216,215,225,181,44,179,2,5 (5ct 0st),1.046
108,8,Rashid Latif (PAK),1992-2003,166,164,220,182,38,182,0,5 (5ct 0st),1.341
109,9,DPMD Jayawardene (Asia/SL),1998-2015,448,443,218,218,0,0,218,4 (4ct 0st),0.492
110,10,R Dravid (Asia/ICC/INDIA),1996-2011,344,341,210,196,14,72,124,4 (4ct 0st),0.615
111,11,RS Kaluwitharana (SL),1990-2004,189,188,207,132,75,131,1,5 (4ct 1st),1.101
112,12,PJL Dujon (WI),1981-1991,169,168,204,183,21,183,0,4 (4ct 0st),1.214
113,13,JC Buttler (ENG),2012-2019,142,138,202,171,31,171,0,6 (6ct 0st),1.463
114,14,RD Jacobs (WI),1996-2004,147,145,189,160,29,160,0,6 (5ct 1st),1.3030000000000002
115,15,Kamran Akmal (PAK),2002-2017,157,154,188,157,31,156,1,5 (4ct 1st),1.22
116,16,D Ramdin (WI),2005-2016,139,137,188,181,7,181,0,5 (5ct 0st),1.372
117,17,AB de Villiers (Afr/SA),2005-2018,228,223,181,176,5,93,83,5 (5ct 0st),0.8109999999999999
118,18,BJ Haddin (AUS),2001-2015,126,124,181,170,11,170,0,5 (5ct 0st),1.459
119,19,AJ Stewart (ENG),1989-2003,170,169,174,159,15,148,11,6 (6ct 0st),1.029
120,20,A Flower (ZIM),1992-2003,213,212,173,141,32,133,8,5 (5ct 0st),0.816
121,21,Q de Kock (SA),2013-2019,115,111,166,158,8,158,0,6 (5ct 1st),1.495
122,22,DJ Richardson (SA),1991-1998,122,121,165,148,17,148,0,5 (5ct 0st),1.3630000000000002
123,23,RT Ponting (AUS/ICC),1995-2012,375,372,160,160,0,0,160,3 (3ct 0st),0.43
124,24,M Azharuddin (INDIA),1985-2000,334,332,156,156,0,0,156,4 (4ct 0st),0.469
125,25,NR Mongia (INDIA),1994-2000,140,139,154,110,44,110,0,5 (4ct 1st),1.107
126,26,BRM Taylor (ZIM),2004-2019,193,193,154,125,29,96,29,5 (5ct 0st),0.797
127,27,T Taibu (Afr/ZIM),2001-2012,150,150,147,114,33,112,2,4 (4ct 0st),0.98
128,28,AC Parore (NZ),1992-2002,179,178,141,116,25,111,5,5 (3ct 2st),0.792
129,29,Sarfaraz Ahmed (PAK),2007-2019,116,114,140,116,24,116,0,6 (6ct 0st),1.228
130,30,SR Tendulkar (INDIA),1989-2012,463,456,140,140,0,0,140,4 (4ct 0st),0.307
131,31,LRPL Taylor (NZ),2006-2019,228,224,137,137,0,0,137,4 (4ct 0st),0.611
132,32,Younis Khan (PAK),2000-2015,265,260,135,135,0,5,130,4 (4ct 0st),0.519
133,33,SP Fleming (ICC/NZ),1994-2007,280,276,133,133,0,0,133,4 (4ct 0st),0.481
134,34,JH Kallis (Afr/ICC/SA),1996-2014,328,324,131,131,0,0,131,3 (3ct 0st),0.4039999999999999
135,35,M Muralitharan (Asia/ICC/SL),1993-2011,350,347,130,130,0,0,130,3 (3ct 0st),0.374
136,36,AR Border (AUS),1979-1994,273,270,127,127,0,0,127,3 (3ct 0st),0.47
137,37,Shahid Afridi (Asia/ICC/PAK),1996-2015,398,392,127,127,0,0,127,2 (2ct 0st),0.3229999999999999
138,38,Khaled Mashud (BDESH),1995-2006,126,126,126,91,35,91,0,5 (3ct 2st),1.0
139,39,TM Dilshan (SL),1999-2016,330,325,124,123,1,5,118,3 (3ct 0st),0.381
140,40,CH Gayle (ICC/WI),1999-2019,301,294,124,124,0,0,124,3 (3ct 0st),0.421
141,41,V Kohli (INDIA),2008-2019,242,240,124,124,0,0,124,3 (3ct 0st),0.516
142,42,RW Marsh (AUS),1971-1984,92,92,124,120,4,120,0,5 (5ct 0st),1.347
143,43,ST Jayasuriya (Asia/SL),1989-2011,445,441,123,123,0,0,123,3 (3ct 0st),0.278
144,44,CL Hooper (WI),1987-2003,227,225,120,120,0,0,120,4 (4ct 0st),0.5329999999999999
145,45,BC Lara (ICC/WI),1990-2007,299,296,120,120,0,0,120,3 (3ct 0st),0.405
146,46,L Ronchi (AUS/NZ),2008-2017,85,83,117,105,12,105,0,4 (4ct 0st),1.409
147,47,MS Wade (AUS),2012-2017,94,94,117,108,9,108,0,5 (5ct 0st),1.244
148,48,Inzamam-ul-Haq (Asia/PAK),1991-2007,378,373,113,113,0,0,113,3 (3ct 0st),0.302
149,49,SR Waugh (AUS),1986-2002,325,324,111,111,0,0,111,3 (3ct 0st),0.342
150,0,KC Sangakkara (Asia/ICC/SL),2000-2015,404,397,501,402,99,383,19,5 (4ct 1st),1.261
151,1,AC Gilchrist (AUS/ICC),1996-2008,287,286,472,417,55,417,0,6 (6ct 0st),1.65
152,2,MS Dhoni (Asia/INDIA),2004-2019,350,345,444,321,123,321,0,6 (5ct 1st),1.286
153,3,MV Boucher (Afr/SA),1998-2011,295,291,425,403,22,402,1,6 (6ct 0st),1.46
154,4,Moin Khan (PAK),1990-2004,219,217,287,214,73,214,0,5 (5ct 0st),1.3219999999999998
155,5,BB McCullum (NZ),2002-2016,260,257,277,262,15,227,35,5 (5ct 0st),1.077
156,6,IA Healy (AUS),1988-1997,168,168,233,194,39,194,0,4 (4ct 0st),1.386
157,7,Mushfiqur Rahim (BDESH),2006-2019,216,215,225,181,44,179,2,5 (5ct 0st),1.046
158,8,Rashid Latif (PAK),1992-2003,166,164,220,182,38,182,0,5 (5ct 0st),1.341
159,9,DPMD Jayawardene (Asia/SL),1998-2015,448,443,218,218,0,0,218,4 (4ct 0st),0.492
160,10,R Dravid (Asia/ICC/INDIA),1996-2011,344,341,210,196,14,72,124,4 (4ct 0st),0.615
161,11,RS Kaluwitharana (SL),1990-2004,189,188,207,132,75,131,1,5 (4ct 1st),1.101
162,12,PJL Dujon (WI),1981-1991,169,168,204,183,21,183,0,4 (4ct 0st),1.214
163,13,JC Buttler (ENG),2012-2019,142,138,202,171,31,171,0,6 (6ct 0st),1.463
164,14,RD Jacobs (WI),1996-2004,147,145,189,160,29,160,0,6 (5ct 1st),1.3030000000000002
165,15,Kamran Akmal (PAK),2002-2017,157,154,188,157,31,156,1,5 (4ct 1st),1.22
166,16,D Ramdin (WI),2005-2016,139,137,188,181,7,181,0,5 (5ct 0st),1.372
167,17,AB de Villiers (Afr/SA),2005-2018,228,223,181,176,5,93,83,5 (5ct 0st),0.8109999999999999
168,18,BJ Haddin (AUS),2001-2015,126,124,181,170,11,170,0,5 (5ct 0st),1.459
169,19,AJ Stewart (ENG),1989-2003,170,169,174,159,15,148,11,6 (6ct 0st),1.029
170,20,A Flower (ZIM),1992-2003,213,212,173,141,32,133,8,5 (5ct 0st),0.816
171,21,Q de Kock (SA),2013-2019,115,111,166,158,8,158,0,6 (5ct 1st),1.495
172,22,DJ Richardson (SA),1991-1998,122,121,165,148,17,148,0,5 (5ct 0st),1.3630000000000002
173,23,RT Ponting (AUS/ICC),1995-2012,375,372,160,160,0,0,160,3 (3ct 0st),0.43
174,24,M Azharuddin (INDIA),1985-2000,334,332,156,156,0,0,156,4 (4ct 0st),0.469
175,25,NR Mongia (INDIA),1994-2000,140,139,154,110,44,110,0,5 (4ct 1st),1.107
176,26,BRM Taylor (ZIM),2004-2019,193,193,154,125,29,96,29,5 (5ct 0st),0.797
177,27,T Taibu (Afr/ZIM),2001-2012,150,150,147,114,33,112,2,4 (4ct 0st),0.98
178,28,AC Parore (NZ),1992-2002,179,178,141,116,25,111,5,5 (3ct 2st),0.792
179,29,Sarfaraz Ahmed (PAK),2007-2019,116,114,140,116,24,116,0,6 (6ct 0st),1.228
180,30,SR Tendulkar (INDIA),1989-2012,463,456,140,140,0,0,140,4 (4ct 0st),0.307
181,31,LRPL Taylor (NZ),2006-2019,228,224,137,137,0,0,137,4 (4ct 0st),0.611
182,32,Younis Khan (PAK),2000-2015,265,260,135,135,0,5,130,4 (4ct 0st),0.519
183,33,SP Fleming (ICC/NZ),1994-2007,280,276,133,133,0,0,133,4 (4ct 0st),0.481
184,34,JH Kallis (Afr/ICC/SA),1996-2014,328,324,131,131,0,0,131,3 (3ct 0st),0.4039999999999999
185,35,M Muralitharan (Asia/ICC/SL),1993-2011,350,347,130,130,0,0,130,3 (3ct 0st),0.374
186,36,AR Border (AUS),1979-1994,273,270,127,127,0,0,127,3 (3ct 0st),0.47
187,37,Shahid Afridi (Asia/ICC/PAK),1996-2015,398,392,127,127,0,0,127,2 (2ct 0st),0.3229999999999999
188,38,Khaled Mashud (BDESH),1995-2006,126,126,126,91,35,91,0,5 (3ct 2st),1.0
189,39,TM Dilshan (SL),1999-2016,330,325,124,123,1,5,118,3 (3ct 0st),0.381
190,40,CH Gayle (ICC/WI),1999-2019,301,294,124,124,0,0,124,3 (3ct 0st),0.421
191,41,V Kohli (INDIA),2008-2019,242,240,124,124,0,0,124,3 (3ct 0st),0.516
192,42,RW Marsh (AUS),1971-1984,92,92,124,120,4,120,0,5 (5ct 0st),1.347
193,43,ST Jayasuriya (Asia/SL),1989-2011,445,441,123,123,0,0,123,3 (3ct 0st),0.278
194,44,CL Hooper (WI),1987-2003,227,225,120,120,0,0,120,4 (4ct 0st),0.5329999999999999
195,45,BC Lara (ICC/WI),1990-2007,299,296,120,120,0,0,120,3 (3ct 0st),0.405
196,46,L Ronchi (AUS/NZ),2008-2017,85,83,117,105,12,105,0,4 (4ct 0st),1.409
197,47,MS Wade (AUS),2012-2017,94,94,117,108,9,108,0,5 (5ct 0st),1.244
198,48,Inzamam-ul-Haq (Asia/PAK),1991-2007,378,373,113,113,0,0,113,3 (3ct 0st),0.302
199,49,SR Waugh (AUS),1986-2002,325,324,111,111,0,0,111,3 (3ct 0st),0.342
200,0,KC Sangakkara (Asia/ICC/SL),2000-2015,404,397,501,402,99,383,19,5 (4ct 1st),1.261
201,1,AC Gilchrist (AUS/ICC),1996-2008,287,286,472,417,55,417,0,6 (6ct 0st),1.65
202,2,MS Dhoni (Asia/INDIA),2004-2019,350,345,444,321,123,321,0,6 (5ct 1st),1.286
203,3,MV Boucher (Afr/SA),1998-2011,295,291,425,403,22,402,1,6 (6ct 0st),1.46
204,4,Moin Khan (PAK),1990-2004,219,217,287,214,73,214,0,5 (5ct 0st),1.3219999999999998
205,5,BB McCullum (NZ),2002-2016,260,257,277,262,15,227,35,5 (5ct 0st),1.077
206,6,IA Healy (AUS),1988-1997,168,168,233,194,39,194,0,4 (4ct 0st),1.386
207,7,Mushfiqur Rahim (BDESH),2006-2019,216,215,225,181,44,179,2,5 (5ct 0st),1.046
208,8,Rashid Latif (PAK),1992-2003,166,164,220,182,38,182,0,5 (5ct 0st),1.341
209,9,DPMD Jayawardene (Asia/SL),1998-2015,448,443,218,218,0,0,218,4 (4ct 0st),0.492
210,10,R Dravid (Asia/ICC/INDIA),1996-2011,344,341,210,196,14,72,124,4 (4ct 0st),0.615
211,11,RS Kaluwitharana (SL),1990-2004,189,188,207,132,75,131,1,5 (4ct 1st),1.101
212,12,PJL Dujon (WI),1981-1991,169,168,204,183,21,183,0,4 (4ct 0st),1.214
213,13,JC Buttler (ENG),2012-2019,142,138,202,171,31,171,0,6 (6ct 0st),1.463
214,14,RD Jacobs (WI),1996-2004,147,145,189,160,29,160,0,6 (5ct 1st),1.3030000000000002
215,15,Kamran Akmal (PAK),2002-2017,157,154,188,157,31,156,1,5 (4ct 1st),1.22
216,16,D Ramdin (WI),2005-2016,139,137,188,181,7,181,0,5 (5ct 0st),1.372
217,17,AB de Villiers (Afr/SA),2005-2018,228,223,181,176,5,93,83,5 (5ct 0st),0.8109999999999999
218,18,BJ Haddin (AUS),2001-2015,126,124,181,170,11,170,0,5 (5ct 0st),1.459
219,19,AJ Stewart (ENG),1989-2003,170,169,174,159,15,148,11,6 (6ct 0st),1.029
220,20,A Flower (ZIM),1992-2003,213,212,173,141,32,133,8,5 (5ct 0st),0.816
221,21,Q de Kock (SA),2013-2019,115,111,166,158,8,158,0,6 (5ct 1st),1.495
222,22,DJ Richardson (SA),1991-1998,122,121,165,148,17,148,0,5 (5ct 0st),1.3630000000000002
223,23,RT Ponting (AUS/ICC),1995-2012,375,372,160,160,0,0,160,3 (3ct 0st),0.43
224,24,M Azharuddin (INDIA),1985-2000,334,332,156,156,0,0,156,4 (4ct 0st),0.469
225,25,NR Mongia (INDIA),1994-2000,140,139,154,110,44,110,0,5 (4ct 1st),1.107
226,26,BRM Taylor (ZIM),2004-2019,193,193,154,125,29,96,29,5 (5ct 0st),0.797
227,27,T Taibu (Afr/ZIM),2001-2012,150,150,147,114,33,112,2,4 (4ct 0st),0.98
228,28,AC Parore (NZ),1992-2002,179,178,141,116,25,111,5,5 (3ct 2st),0.792
229,29,Sarfaraz Ahmed (PAK),2007-2019,116,114,140,116,24,116,0,6 (6ct 0st),1.228
230,30,SR Tendulkar (INDIA),1989-2012,463,456,140,140,0,0,140,4 (4ct 0st),0.307
231,31,LRPL Taylor (NZ),2006-2019,228,224,137,137,0,0,137,4 (4ct 0st),0.611
232,32,Younis Khan (PAK),2000-2015,265,260,135,135,0,5,130,4 (4ct 0st),0.519
233,33,SP Fleming (ICC/NZ),1994-2007,280,276,133,133,0,0,133,4 (4ct 0st),0.481
234,34,JH Kallis (Afr/ICC/SA),1996-2014,328,324,131,131,0,0,131,3 (3ct 0st),0.4039999999999999
235,35,M Muralitharan (Asia/ICC/SL),1993-2011,350,347,130,130,0,0,130,3 (3ct 0st),0.374
236,36,AR Border (AUS),1979-1994,273,270,127,127,0,0,127,3 (3ct 0st),0.47
237,37,Shahid Afridi (Asia/ICC/PAK),1996-2015,398,392,127,127,0,0,127,2 (2ct 0st),0.3229999999999999
238,38,Khaled Mashud (BDESH),1995-2006,126,126,126,91,35,91,0,5 (3ct 2st),1.0
239,39,TM Dilshan (SL),1999-2016,330,325,124,123,1,5,118,3 (3ct 0st),0.381
240,40,CH Gayle (ICC/WI),1999-2019,301,294,124,124,0,0,124,3 (3ct 0st),0.421
241,41,V Kohli (INDIA),2008-2019,242,240,124,124,0,0,124,3 (3ct 0st),0.516
242,42,RW Marsh (AUS),1971-1984,92,92,124,120,4,120,0,5 (5ct 0st),1.347
243,43,ST Jayasuriya (Asia/SL),1989-2011,445,441,123,123,0,0,123,3 (3ct 0st),0.278
244,44,CL Hooper (WI),1987-2003,227,225,120,120,0,0,120,4 (4ct 0st),0.5329999999999999
245,45,BC Lara (ICC/WI),1990-2007,299,296,120,120,0,0,120,3 (3ct 0st),0.405
246,46,L Ronchi (AUS/NZ),2008-2017,85,83,117,105,12,105,0,4 (4ct 0st),1.409
247,47,MS Wade (AUS),2012-2017,94,94,117,108,9,108,0,5 (5ct 0st),1.244
248,48,Inzamam-ul-Haq (Asia/PAK),1991-2007,378,373,113,113,0,0,113,3 (3ct 0st),0.302
249,49,SR Waugh (AUS),1986-2002,325,324,111,111,0,0,111,3 (3ct 0st),0.342
250,0,KC Sangakkara (Asia/ICC/SL),2000-2015,404,397,501,402,99,383,19,5 (4ct 1st),1.261
251,1,AC Gilchrist (AUS/ICC),1996-2008,287,286,472,417,55,417,0,6 (6ct 0st),1.65
252,2,MS Dhoni (Asia/INDIA),2004-2019,350,345,444,321,123,321,0,6 (5ct 1st),1.286
253,3,MV Boucher (Afr/SA),1998-2011,295,291,425,403,22,402,1,6 (6ct 0st),1.46
254,4,Moin Khan (PAK),1990-2004,219,217,287,214,73,214,0,5 (5ct 0st),1.3219999999999998
255,5,BB McCullum (NZ),2002-2016,260,257,277,262,15,227,35,5 (5ct 0st),1.077
256,6,IA Healy (AUS),1988-1997,168,168,233,194,39,194,0,4 (4ct 0st),1.386
257,7,Mushfiqur Rahim (BDESH),2006-2019,216,215,225,181,44,179,2,5 (5ct 0st),1.046
258,8,Rashid Latif (PAK),1992-2003,166,164,220,182,38,182,0,5 (5ct 0st),1.341
259,9,DPMD Jayawardene (Asia/SL),1998-2015,448,443,218,218,0,0,218,4 (4ct 0st),0.492
260,10,R Dravid (Asia/ICC/INDIA),1996-2011,344,341,210,196,14,72,124,4 (4ct 0st),0.615
261,11,RS Kaluwitharana (SL),1990-2004,189,188,207,132,75,131,1,5 (4ct 1st),1.101
262,12,PJL Dujon (WI),1981-1991,169,168,204,183,21,183,0,4 (4ct 0st),1.214
263,13,JC Buttler (ENG),2012-2019,142,138,202,171,31,171,0,6 (6ct 0st),1.463
264,14,RD Jacobs (WI),1996-2004,147,145,189,160,29,160,0,6 (5ct 1st),1.3030000000000002
265,15,Kamran Akmal (PAK),2002-2017,157,154,188,157,31,156,1,5 (4ct 1st),1.22
266,16,D Ramdin (WI),2005-2016,139,137,188,181,7,181,0,5 (5ct 0st),1.372
267,17,AB de Villiers (Afr/SA),2005-2018,228,223,181,176,5,93,83,5 (5ct 0st),0.8109999999999999
268,18,BJ Haddin (AUS),2001-2015,126,124,181,170,11,170,0,5 (5ct 0st),1.459
269,19,AJ Stewart (ENG),1989-2003,170,169,174,159,15,148,11,6 (6ct 0st),1.029
270,20,A Flower (ZIM),1992-2003,213,212,173,141,32,133,8,5 (5ct 0st),0.816
271,21,Q de Kock (SA),2013-2019,115,111,166,158,8,158,0,6 (5ct 1st),1.495
272,22,DJ Richardson (SA),1991-1998,122,121,165,148,17,148,0,5 (5ct 0st),1.3630000000000002
273,23,RT Ponting (AUS/ICC),1995-2012,375,372,160,160,0,0,160,3 (3ct 0st),0.43
274,24,M Azharuddin (INDIA),1985-2000,334,332,156,156,0,0,156,4 (4ct 0st),0.469
275,25,NR Mongia (INDIA),1994-2000,140,139,154,110,44,110,0,5 (4ct 1st),1.107
276,26,BRM Taylor (ZIM),2004-2019,193,193,154,125,29,96,29,5 (5ct 0st),0.797
277,27,T Taibu (Afr/ZIM),2001-2012,150,150,147,114,33,112,2,4 (4ct 0st),0.98
278,28,AC Parore (NZ),1992-2002,179,178,141,116,25,111,5,5 (3ct 2st),0.792
279,29,Sarfaraz Ahmed (PAK),2007-2019,116,114,140,116,24,116,0,6 (6ct 0st),1.228
280,30,SR Tendulkar (INDIA),1989-2012,463,456,140,140,0,0,140,4 (4ct 0st),0.307
281,31,LRPL Taylor (NZ),2006-2019,228,224,137,137,0,0,137,4 (4ct 0st),0.611
282,32,Younis Khan (PAK),2000-2015,265,260,135,135,0,5,130,4 (4ct 0st),0.519
283,33,SP Fleming (ICC/NZ),1994-2007,280,276,133,133,0,0,133,4 (4ct 0st),0.481
284,34,JH Kallis (Afr/ICC/SA),1996-2014,328,324,131,131,0,0,131,3 (3ct 0st),0.4039999999999999
285,35,M Muralitharan (Asia/ICC/SL),1993-2011,350,347,130,130,0,0,130,3 (3ct 0st),0.374
286,36,AR Border (AUS),1979-1994,273,270,127,127,0,0,127,3 (3ct 0st),0.47
287,37,Shahid Afridi (Asia/ICC/PAK),1996-2015,398,392,127,127,0,0,127,2 (2ct 0st),0.3229999999999999
288,38,Khaled Mashud (BDESH),1995-2006,126,126,126,91,35,91,0,5 (3ct 2st),1.0
289,39,TM Dilshan (SL),1999-2016,330,325,124,123,1,5,118,3 (3ct 0st),0.381
290,40,CH Gayle (ICC/WI),1999-2019,301,294,124,124,0,0,124,3 (3ct 0st),0.421
291,41,V Kohli (INDIA),2008-2019,242,240,124,124,0,0,124,3 (3ct 0st),0.516
292,42,RW Marsh (AUS),1971-1984,92,92,124,120,4,120,0,5 (5ct 0st),1.347
293,43,ST Jayasuriya (Asia/SL),1989-2011,445,441,123,123,0,0,123,3 (3ct 0st),0.278
294,44,CL Hooper (WI),1987-2003,227,225,120,120,0,0,120,4 (4ct 0st),0.5329999999999999
295,45,BC Lara (ICC/WI),1990-2007,299,296,120,120,0,0,120,3 (3ct 0st),0.405
296,46,L Ronchi (AUS/NZ),2008-2017,85,83,117,105,12,105,0,4 (4ct 0st),1.409
297,47,MS Wade (AUS),2012-2017,94,94,117,108,9,108,0,5 (5ct 0st),1.244
298,48,Inzamam-ul-Haq (Asia/PAK),1991-2007,378,373,113,113,0,0,113,3 (3ct 0st),0.302
299,49,SR Waugh (AUS),1986-2002,325,324,111,111,0,0,111,3 (3ct 0st),0.342
300,0,KC Sangakkara (Asia/ICC/SL),2000-2015,404,397,501,402,99,383,19,5 (4ct 1st),1.261
301,1,AC Gilchrist (AUS/ICC),1996-2008,287,286,472,417,55,417,0,6 (6ct 0st),1.65
302,2,MS Dhoni (Asia/INDIA),2004-2019,350,345,444,321,123,321,0,6 (5ct 1st),1.286
303,3,MV Boucher (Afr/SA),1998-2011,295,291,425,403,22,402,1,6 (6ct 0st),1.46
304,4,Moin Khan (PAK),1990-2004,219,217,287,214,73,214,0,5 (5ct 0st),1.3219999999999998
305,5,BB McCullum (NZ),2002-2016,260,257,277,262,15,227,35,5 (5ct 0st),1.077
306,6,IA Healy (AUS),1988-1997,168,168,233,194,39,194,0,4 (4ct 0st),1.386
307,7,Mushfiqur Rahim (BDESH),2006-2019,216,215,225,181,44,179,2,5 (5ct 0st),1.046
308,8,Rashid Latif (PAK),1992-2003,166,164,220,182,38,182,0,5 (5ct 0st),1.341
309,9,DPMD Jayawardene (Asia/SL),1998-2015,448,443,218,218,0,0,218,4 (4ct 0st),0.492
310,10,R Dravid (Asia/ICC/INDIA),1996-2011,344,341,210,196,14,72,124,4 (4ct 0st),0.615
311,11,RS Kaluwitharana (SL),1990-2004,189,188,207,132,75,131,1,5 (4ct 1st),1.101
312,12,PJL Dujon (WI),1981-1991,169,168,204,183,21,183,0,4 (4ct 0st),1.214
313,13,JC Buttler (ENG),2012-2019,142,138,202,171,31,171,0,6 (6ct 0st),1.463
314,14,RD Jacobs (WI),1996-2004,147,145,189,160,29,160,0,6 (5ct 1st),1.3030000000000002
315,15,Kamran Akmal (PAK),2002-2017,157,154,188,157,31,156,1,5 (4ct 1st),1.22
316,16,D Ramdin (WI),2005-2016,139,137,188,181,7,181,0,5 (5ct 0st),1.372
317,17,AB de Villiers (Afr/SA),2005-2018,228,223,181,176,5,93,83,5 (5ct 0st),0.8109999999999999
318,18,BJ Haddin (AUS),2001-2015,126,124,181,170,11,170,0,5 (5ct 0st),1.459
319,19,AJ Stewart (ENG),1989-2003,170,169,174,159,15,148,11,6 (6ct 0st),1.029
320,20,A Flower (ZIM),1992-2003,213,212,173,141,32,133,8,5 (5ct 0st),0.816
321,21,Q de Kock (SA),2013-2019,115,111,166,158,8,158,0,6 (5ct 1st),1.495
322,22,DJ Richardson (SA),1991-1998,122,121,165,148,17,148,0,5 (5ct 0st),1.3630000000000002
323,23,RT Ponting (AUS/ICC),1995-2012,375,372,160,160,0,0,160,3 (3ct 0st),0.43
324,24,M Azharuddin (INDIA),1985-2000,334,332,156,156,0,0,156,4 (4ct 0st),0.469
325,25,NR Mongia (INDIA),1994-2000,140,139,154,110,44,110,0,5 (4ct 1st),1.107
326,26,BRM Taylor (ZIM),2004-2019,193,193,154,125,29,96,29,5 (5ct 0st),0.797
327,27,T Taibu (Afr/ZIM),2001-2012,150,150,147,114,33,112,2,4 (4ct 0st),0.98
328,28,AC Parore (NZ),1992-2002,179,178,141,116,25,111,5,5 (3ct 2st),0.792
329,29,Sarfaraz Ahmed (PAK),2007-2019,116,114,140,116,24,116,0,6 (6ct 0st),1.228
330,30,SR Tendulkar (INDIA),1989-2012,463,456,140,140,0,0,140,4 (4ct 0st),0.307
331,31,LRPL Taylor (NZ),2006-2019,228,224,137,137,0,0,137,4 (4ct 0st),0.611
332,32,Younis Khan (PAK),2000-2015,265,260,135,135,0,5,130,4 (4ct 0st),0.519
333,33,SP Fleming (ICC/NZ),1994-2007,280,276,133,133,0,0,133,4 (4ct 0st),0.481
334,34,JH Kallis (Afr/ICC/SA),1996-2014,328,324,131,131,0,0,131,3 (3ct 0st),0.4039999999999999
335,35,M Muralitharan (Asia/ICC/SL),1993-2011,350,347,130,130,0,0,130,3 (3ct 0st),0.374
336,36,AR Border (AUS),1979-1994,273,270,127,127,0,0,127,3 (3ct 0st),0.47
337,37,Shahid Afridi (Asia/ICC/PAK),1996-2015,398,392,127,127,0,0,127,2 (2ct 0st),0.3229999999999999
338,38,Khaled Mashud (BDESH),1995-2006,126,126,126,91,35,91,0,5 (3ct 2st),1.0
339,39,TM Dilshan (SL),1999-2016,330,325,124,123,1,5,118,3 (3ct 0st),0.381
340,40,CH Gayle (ICC/WI),1999-2019,301,294,124,124,0,0,124,3 (3ct 0st),0.421
341,41,V Kohli (INDIA),2008-2019,242,240,124,124,0,0,124,3 (3ct 0st),0.516
342,42,RW Marsh (AUS),1971-1984,92,92,124,120,4,120,0,5 (5ct 0st),1.347
343,43,ST Jayasuriya (Asia/SL),1989-2011,445,441,123,123,0,0,123,3 (3ct 0st),0.278
344,44,CL Hooper (WI),1987-2003,227,225,120,120,0,0,120,4 (4ct 0st),0.5329999999999999
345,45,BC Lara (ICC/WI),1990-2007,299,296,120,120,0,0,120,3 (3ct 0st),0.405
346,46,L Ronchi (AUS/NZ),2008-2017,85,83,117,105,12,105,0,4 (4ct 0st),1.409
347,47,MS Wade (AUS),2012-2017,94,94,117,108,9,108,0,5 (5ct 0st),1.244
348,48,Inzamam-ul-Haq (Asia/PAK),1991-2007,378,373,113,113,0,0,113,3 (3ct 0st),0.302
349,49,SR Waugh (AUS),1986-2002,325,324,111,111,0,0,111,3 (3ct 0st),0.342
350,0,KC Sangakkara (Asia/ICC/SL),2000-2015,404,397,501,402,99,383,19,5 (4ct 1st),1.261
351,1,AC Gilchrist (AUS/ICC),1996-2008,287,286,472,417,55,417,0,6 (6ct 0st),1.65
352,2,MS Dhoni (Asia/INDIA),2004-2019,350,345,444,321,123,321,0,6 (5ct 1st),1.286
353,3,MV Boucher (Afr/SA),1998-2011,295,291,425,403,22,402,1,6 (6ct 0st),1.46
354,4,Moin Khan (PAK),1990-2004,219,217,287,214,73,214,0,5 (5ct 0st),1.3219999999999998
355,5,BB McCullum (NZ),2002-2016,260,257,277,262,15,227,35,5 (5ct 0st),1.077
356,6,IA Healy (AUS),1988-1997,168,168,233,194,39,194,0,4 (4ct 0st),1.386
357,7,Mushfiqur Rahim (BDESH),2006-2019,216,215,225,181,44,179,2,5 (5ct 0st),1.046
358,8,Rashid Latif (PAK),1992-2003,166,164,220,182,38,182,0,5 (5ct 0st),1.341
359,9,DPMD Jayawardene (Asia/SL),1998-2015,448,443,218,218,0,0,218,4 (4ct 0st),0.492
360,10,R Dravid (Asia/ICC/INDIA),1996-2011,344,341,210,196,14,72,124,4 (4ct 0st),0.615
361,11,RS Kaluwitharana (SL),1990-2004,189,188,207,132,75,131,1,5 (4ct 1st),1.101
362,12,PJL Dujon (WI),1981-1991,169,168,204,183,21,183,0,4 (4ct 0st),1.214
363,13,JC Buttler (ENG),2012-2019,142,138,202,171,31,171,0,6 (6ct 0st),1.463
364,14,RD Jacobs (WI),1996-2004,147,145,189,160,29,160,0,6 (5ct 1st),1.3030000000000002
365,15,Kamran Akmal (PAK),2002-2017,157,154,188,157,31,156,1,5 (4ct 1st),1.22
366,16,D Ramdin (WI),2005-2016,139,137,188,181,7,181,0,5 (5ct 0st),1.372
367,17,AB de Villiers (Afr/SA),2005-2018,228,223,181,176,5,93,83,5 (5ct 0st),0.8109999999999999
368,18,BJ Haddin (AUS),2001-2015,126,124,181,170,11,170,0,5 (5ct 0st),1.459
369,19,AJ Stewart (ENG),1989-2003,170,169,174,159,15,148,11,6 (6ct 0st),1.029
370,20,A Flower (ZIM),1992-2003,213,212,173,141,32,133,8,5 (5ct 0st),0.816
371,21,Q de Kock (SA),2013-2019,115,111,166,158,8,158,0,6 (5ct 1st),1.495
372,22,DJ Richardson (SA),1991-1998,122,121,165,148,17,148,0,5 (5ct 0st),1.3630000000000002
373,23,RT Ponting (AUS/ICC),1995-2012,375,372,160,160,0,0,160,3 (3ct 0st),0.43
374,24,M Azharuddin (INDIA),1985-2000,334,332,156,156,0,0,156,4 (4ct 0st),0.469
375,25,NR Mongia (INDIA),1994-2000,140,139,154,110,44,110,0,5 (4ct 1st),1.107
376,26,BRM Taylor (ZIM),2004-2019,193,193,154,125,29,96,29,5 (5ct 0st),0.797
377,27,T Taibu (Afr/ZIM),2001-2012,150,150,147,114,33,112,2,4 (4ct 0st),0.98
378,28,AC Parore (NZ),1992-2002,179,178,141,116,25,111,5,5 (3ct 2st),0.792
379,29,Sarfaraz Ahmed (PAK),2007-2019,116,114,140,116,24,116,0,6 (6ct 0st),1.228
380,30,SR Tendulkar (INDIA),1989-2012,463,456,140,140,0,0,140,4 (4ct 0st),0.307
381,31,LRPL Taylor (NZ),2006-2019,228,224,137,137,0,0,137,4 (4ct 0st),0.611
382,32,Younis Khan (PAK),2000-2015,265,260,135,135,0,5,130,4 (4ct 0st),0.519
383,33,SP Fleming (ICC/NZ),1994-2007,280,276,133,133,0,0,133,4 (4ct 0st),0.481
384,34,JH Kallis (Afr/ICC/SA),1996-2014,328,324,131,131,0,0,131,3 (3ct 0st),0.4039999999999999
385,35,M Muralitharan (Asia/ICC/SL),1993-2011,350,347,130,130,0,0,130,3 (3ct 0st),0.374
386,36,AR Border (AUS),1979-1994,273,270,127,127,0,0,127,3 (3ct 0st),0.47
387,37,Shahid Afridi (Asia/ICC/PAK),1996-2015,398,392,127,127,0,0,127,2 (2ct 0st),0.3229999999999999
388,38,Khaled Mashud (BDESH),1995-2006,126,126,126,91,35,91,0,5 (3ct 2st),1.0
389,39,TM Dilshan (SL),1999-2016,330,325,124,123,1,5,118,3 (3ct 0st),0.381
390,40,CH Gayle (ICC/WI),1999-2019,301,294,124,124,0,0,124,3 (3ct 0st),0.421
391,41,V Kohli (INDIA),2008-2019,242,240,124,124,0,0,124,3 (3ct 0st),0.516
392,42,RW Marsh (AUS),1971-1984,92,92,124,120,4,120,0,5 (5ct 0st),1.347
393,43,ST Jayasuriya (Asia/SL),1989-2011,445,441,123,123,0,0,123,3 (3ct 0st),0.278
394,44,CL Hooper (WI),1987-2003,227,225,120,120,0,0,120,4 (4ct 0st),0.5329999999999999
395,45,BC Lara (ICC/WI),1990-2007,299,296,120,120,0,0,120,3 (3ct 0st),0.405
396,46,L Ronchi (AUS/NZ),2008-2017,85,83,117,105,12,105,0,4 (4ct 0st),1.409
397,47,MS Wade (AUS),2012-2017,94,94,117,108,9,108,0,5 (5ct 0st),1.244
398,48,Inzamam-ul-Haq (Asia/PAK),1991-2007,378,373,113,113,0,0,113,3 (3ct 0st),0.302
399,49,SR Waugh (AUS),1986-2002,325,324,111,111,0,0,111,3 (3ct 0st),0.342
400,0,KC Sangakkara (Asia/ICC/SL),2000-2015,404,397,501,402,99,383,19,5 (4ct 1st),1.261
401,1,AC Gilchrist (AUS/ICC),1996-2008,287,286,472,417,55,417,0,6 (6ct 0st),1.65
402,2,MS Dhoni (Asia/INDIA),2004-2019,350,345,444,321,123,321,0,6 (5ct 1st),1.286
403,3,MV Boucher (Afr/SA),1998-2011,295,291,425,403,22,402,1,6 (6ct 0st),1.46
404,4,Moin Khan (PAK),1990-2004,219,217,287,214,73,214,0,5 (5ct 0st),1.3219999999999998
405,5,BB McCullum (NZ),2002-2016,260,257,277,262,15,227,35,5 (5ct 0st),1.077
406,6,IA Healy (AUS),1988-1997,168,168,233,194,39,194,0,4 (4ct 0st),1.386
407,7,Mushfiqur Rahim (BDESH),2006-2019,216,215,225,181,44,179,2,5 (5ct 0st),1.046
408,8,Rashid Latif (PAK),1992-2003,166,164,220,182,38,182,0,5 (5ct 0st),1.341
409,9,DPMD Jayawardene (Asia/SL),1998-2015,448,443,218,218,0,0,218,4 (4ct 0st),0.492
410,10,R Dravid (Asia/ICC/INDIA),1996-2011,344,341,210,196,14,72,124,4 (4ct 0st),0.615
411,11,RS Kaluwitharana (SL),1990-2004,189,188,207,132,75,131,1,5 (4ct 1st),1.101
412,12,PJL Dujon (WI),1981-1991,169,168,204,183,21,183,0,4 (4ct 0st),1.214
413,13,JC Buttler (ENG),2012-2019,142,138,202,171,31,171,0,6 (6ct 0st),1.463
414,14,RD Jacobs (WI),1996-2004,147,145,189,160,29,160,0,6 (5ct 1st),1.3030000000000002
415,15,Kamran Akmal (PAK),2002-2017,157,154,188,157,31,156,1,5 (4ct 1st),1.22
416,16,D Ramdin (WI),2005-2016,139,137,188,181,7,181,0,5 (5ct 0st),1.372
417,17,AB de Villiers (Afr/SA),2005-2018,228,223,181,176,5,93,83,5 (5ct 0st),0.8109999999999999
418,18,BJ Haddin (AUS),2001-2015,126,124,181,170,11,170,0,5 (5ct 0st),1.459
419,19,AJ Stewart (ENG),1989-2003,170,169,174,159,15,148,11,6 (6ct 0st),1.029
420,20,A Flower (ZIM),1992-2003,213,212,173,141,32,133,8,5 (5ct 0st),0.816
421,21,Q de Kock (SA),2013-2019,115,111,166,158,8,158,0,6 (5ct 1st),1.495
422,22,DJ Richardson (SA),1991-1998,122,121,165,148,17,148,0,5 (5ct 0st),1.3630000000000002
423,23,RT Ponting (AUS/ICC),1995-2012,375,372,160,160,0,0,160,3 (3ct 0st),0.43
424,24,M Azharuddin (INDIA),1985-2000,334,332,156,156,0,0,156,4 (4ct 0st),0.469
425,25,NR Mongia (INDIA),1994-2000,140,139,154,110,44,110,0,5 (4ct 1st),1.107
426,26,BRM Taylor (ZIM),2004-2019,193,193,154,125,29,96,29,5 (5ct 0st),0.797
427,27,T Taibu (Afr/ZIM),2001-2012,150,150,147,114,33,112,2,4 (4ct 0st),0.98
428,28,AC Parore (NZ),1992-2002,179,178,141,116,25,111,5,5 (3ct 2st),0.792
429,29,Sarfaraz Ahmed (PAK),2007-2019,116,114,140,116,24,116,0,6 (6ct 0st),1.228
430,30,SR Tendulkar (INDIA),1989-2012,463,456,140,140,0,0,140,4 (4ct 0st),0.307
431,31,LRPL Taylor (NZ),2006-2019,228,224,137,137,0,0,137,4 (4ct 0st),0.611
432,32,Younis Khan (PAK),2000-2015,265,260,135,135,0,5,130,4 (4ct 0st),0.519
433,33,SP Fleming (ICC/NZ),1994-2007,280,276,133,133,0,0,133,4 (4ct 0st),0.481
434,34,JH Kallis (Afr/ICC/SA),1996-2014,328,324,131,131,0,0,131,3 (3ct 0st),0.4039999999999999
435,35,M Muralitharan (Asia/ICC/SL),1993-2011,350,347,130,130,0,0,130,3 (3ct 0st),0.374
436,36,AR Border (AUS),1979-1994,273,270,127,127,0,0,127,3 (3ct 0st),0.47
437,37,Shahid Afridi (Asia/ICC/PAK),1996-2015,398,392,127,127,0,0,127,2 (2ct 0st),0.3229999999999999
438,38,Khaled Mashud (BDESH),1995-2006,126,126,126,91,35,91,0,5 (3ct 2st),1.0
439,39,TM Dilshan (SL),1999-2016,330,325,124,123,1,5,118,3 (3ct 0st),0.381
440,40,CH Gayle (ICC/WI),1999-2019,301,294,124,124,0,0,124,3 (3ct 0st),0.421
441,41,V Kohli (INDIA),2008-2019,242,240,124,124,0,0,124,3 (3ct 0st),0.516
442,42,RW Marsh (AUS),1971-1984,92,92,124,120,4,120,0,5 (5ct 0st),1.347
443,43,ST Jayasuriya (Asia/SL),1989-2011,445,441,123,123,0,0,123,3 (3ct 0st),0.278
444,44,CL Hooper (WI),1987-2003,227,225,120,120,0,0,120,4 (4ct 0st),0.5329999999999999
445,45,BC Lara (ICC/WI),1990-2007,299,296,120,120,0,0,120,3 (3ct 0st),0.405
446,46,L Ronchi (AUS/NZ),2008-2017,85,83,117,105,12,105,0,4 (4ct 0st),1.409
447,47,MS Wade (AUS),2012-2017,94,94,117,108,9,108,0,5 (5ct 0st),1.244
448,48,Inzamam-ul-Haq (Asia/PAK),1991-2007,378,373,113,113,0,0,113,3 (3ct 0st),0.302
449,49,SR Waugh (AUS),1986-2002,325,324,111,111,0,0,111,3 (3ct 0st),0.342
450,0,KC Sangakkara (Asia/ICC/SL),2000-2015,404,397,501,402,99,383,19,5 (4ct 1st),1.261
451,1,AC Gilchrist (AUS/ICC),1996-2008,287,286,472,417,55,417,0,6 (6ct 0st),1.65
452,2,MS Dhoni (Asia/INDIA),2004-2019,350,345,444,321,123,321,0,6 (5ct 1st),1.286
453,3,MV Boucher (Afr/SA),1998-2011,295,291,425,403,22,402,1,6 (6ct 0st),1.46
454,4,Moin Khan (PAK),1990-2004,219,217,287,214,73,214,0,5 (5ct 0st),1.3219999999999998
455,5,BB McCullum (NZ),2002-2016,260,257,277,262,15,227,35,5 (5ct 0st),1.077
456,6,IA Healy (AUS),1988-1997,168,168,233,194,39,194,0,4 (4ct 0st),1.386
457,7,Mushfiqur Rahim (BDESH),2006-2019,216,215,225,181,44,179,2,5 (5ct 0st),1.046
458,8,Rashid Latif (PAK),1992-2003,166,164,220,182,38,182,0,5 (5ct 0st),1.341
459,9,DPMD Jayawardene (Asia/SL),1998-2015,448,443,218,218,0,0,218,4 (4ct 0st),0.492
460,10,R Dravid (Asia/ICC/INDIA),1996-2011,344,341,210,196,14,72,124,4 (4ct 0st),0.615
461,11,RS Kaluwitharana (SL),1990-2004,189,188,207,132,75,131,1,5 (4ct 1st),1.101
462,12,PJL Dujon (WI),1981-1991,169,168,204,183,21,183,0,4 (4ct 0st),1.214
463,13,JC Buttler (ENG),2012-2019,142,138,202,171,31,171,0,6 (6ct 0st),1.463
464,14,RD Jacobs (WI),1996-2004,147,145,189,160,29,160,0,6 (5ct 1st),1.3030000000000002
465,15,Kamran Akmal (PAK),2002-2017,157,154,188,157,31,156,1,5 (4ct 1st),1.22
466,16,D Ramdin (WI),2005-2016,139,137,188,181,7,181,0,5 (5ct 0st),1.372
467,17,AB de Villiers (Afr/SA),2005-2018,228,223,181,176,5,93,83,5 (5ct 0st),0.8109999999999999
468,18,BJ Haddin (AUS),2001-2015,126,124,181,170,11,170,0,5 (5ct 0st),1.459
469,19,AJ Stewart (ENG),1989-2003,170,169,174,159,15,148,11,6 (6ct 0st),1.029
470,20,A Flower (ZIM),1992-2003,213,212,173,141,32,133,8,5 (5ct 0st),0.816
471,21,Q de Kock (SA),2013-2019,115,111,166,158,8,158,0,6 (5ct 1st),1.495
472,22,DJ Richardson (SA),1991-1998,122,121,165,148,17,148,0,5 (5ct 0st),1.3630000000000002
473,23,RT Ponting (AUS/ICC),1995-2012,375,372,160,160,0,0,160,3 (3ct 0st),0.43
474,24,M Azharuddin (INDIA),1985-2000,334,332,156,156,0,0,156,4 (4ct 0st),0.469
475,25,NR Mongia (INDIA),1994-2000,140,139,154,110,44,110,0,5 (4ct 1st),1.107
476,26,BRM Taylor (ZIM),2004-2019,193,193,154,125,29,96,29,5 (5ct 0st),0.797
477,27,T Taibu (Afr/ZIM),2001-2012,150,150,147,114,33,112,2,4 (4ct 0st),0.98
478,28,AC Parore (NZ),1992-2002,179,178,141,116,25,111,5,5 (3ct 2st),0.792
479,29,Sarfaraz Ahmed (PAK),2007-2019,116,114,140,116,24,116,0,6 (6ct 0st),1.228
480,30,SR Tendulkar (INDIA),1989-2012,463,456,140,140,0,0,140,4 (4ct 0st),0.307
481,31,LRPL Taylor (NZ),2006-2019,228,224,137,137,0,0,137,4 (4ct 0st),0.611
482,32,Younis Khan (PAK),2000-2015,265,260,135,135,0,5,130,4 (4ct 0st),0.519
483,33,SP Fleming (ICC/NZ),1994-2007,280,276,133,133,0,0,133,4 (4ct 0st),0.481
484,34,JH Kallis (Afr/ICC/SA),1996-2014,328,324,131,131,0,0,131,3 (3ct 0st),0.4039999999999999
485,35,M Muralitharan (Asia/ICC/SL),1993-2011,350,347,130,130,0,0,130,3 (3ct 0st),0.374
486,36,AR Border (AUS),1979-1994,273,270,127,127,0,0,127,3 (3ct 0st),0.47
487,37,Shahid Afridi (Asia/ICC/PAK),1996-2015,398,392,127,127,0,0,127,2 (2ct 0st),0.3229999999999999
488,38,Khaled Mashud (BDESH),1995-2006,126,126,126,91,35,91,0,5 (3ct 2st),1.0
489,39,TM Dilshan (SL),1999-2016,330,325,124,123,1,5,118,3 (3ct 0st),0.381
490,40,CH Gayle (ICC/WI),1999-2019,301,294,124,124,0,0,124,3 (3ct 0st),0.421
491,41,V Kohli (INDIA),2008-2019,242,240,124,124,0,0,124,3 (3ct 0st),0.516
492,42,RW Marsh (AUS),1971-1984,92,92,124,120,4,120,0,5 (5ct 0st),1.347
493,43,ST Jayasuriya (Asia/SL),1989-2011,445,441,123,123,0,0,123,3 (3ct 0st),0.278
494,44,CL Hooper (WI),1987-2003,227,225,120,120,0,0,120,4 (4ct 0st),0.5329999999999999
495,45,BC Lara (ICC/WI),1990-2007,299,296,120,120,0,0,120,3 (3ct 0st),0.405
496,46,L Ronchi (AUS/NZ),2008-2017,85,83,117,105,12,105,0,4 (4ct 0st),1.409
497,47,MS Wade (AUS),2012-2017,94,94,117,108,9,108,0,5 (5ct 0st),1.244
498,48,Inzamam-ul-Haq (Asia/PAK),1991-2007,378,373,113,113,0,0,113,3 (3ct 0st),0.302
499,49,SR Waugh (AUS),1986-2002,325,324,111,111,0,0,111,3 (3ct 0st),0.342
500,0,KC Sangakkara (Asia/ICC/SL),2000-2015,404,397,501,402,99,383,19,5 (4ct 1st),1.261
501,1,AC Gilchrist (AUS/ICC),1996-2008,287,286,472,417,55,417,0,6 (6ct 0st),1.65
502,2,MS Dhoni (Asia/INDIA),2004-2019,350,345,444,321,123,321,0,6 (5ct 1st),1.286
503,3,MV Boucher (Afr/SA),1998-2011,295,291,425,403,22,402,1,6 (6ct 0st),1.46
504,4,Moin Khan (PAK),1990-2004,219,217,287,214,73,214,0,5 (5ct 0st),1.3219999999999998
505,5,BB McCullum (NZ),2002-2016,260,257,277,262,15,227,35,5 (5ct 0st),1.077
506,6,IA Healy (AUS),1988-1997,168,168,233,194,39,194,0,4 (4ct 0st),1.386
507,7,Mushfiqur Rahim (BDESH),2006-2019,216,215,225,181,44,179,2,5 (5ct 0st),1.046
508,8,Rashid Latif (PAK),1992-2003,166,164,220,182,38,182,0,5 (5ct 0st),1.341
509,9,DPMD Jayawardene (Asia/SL),1998-2015,448,443,218,218,0,0,218,4 (4ct 0st),0.492
510,10,R Dravid (Asia/ICC/INDIA),1996-2011,344,341,210,196,14,72,124,4 (4ct 0st),0.615
511,11,RS Kaluwitharana (SL),1990-2004,189,188,207,132,75,131,1,5 (4ct 1st),1.101
512,12,PJL Dujon (WI),1981-1991,169,168,204,183,21,183,0,4 (4ct 0st),1.214
513,13,JC Buttler (ENG),2012-2019,142,138,202,171,31,171,0,6 (6ct 0st),1.463
514,14,RD Jacobs (WI),1996-2004,147,145,189,160,29,160,0,6 (5ct 1st),1.3030000000000002
515,15,Kamran Akmal (PAK),2002-2017,157,154,188,157,31,156,1,5 (4ct 1st),1.22
516,16,D Ramdin (WI),2005-2016,139,137,188,181,7,181,0,5 (5ct 0st),1.372
517,17,AB de Villiers (Afr/SA),2005-2018,228,223,181,176,5,93,83,5 (5ct 0st),0.8109999999999999
518,18,BJ Haddin (AUS),2001-2015,126,124,181,170,11,170,0,5 (5ct 0st),1.459
519,19,AJ Stewart (ENG),1989-2003,170,169,174,159,15,148,11,6 (6ct 0st),1.029
520,20,A Flower (ZIM),1992-2003,213,212,173,141,32,133,8,5 (5ct 0st),0.816
521,21,Q de Kock (SA),2013-2019,115,111,166,158,8,158,0,6 (5ct 1st),1.495
522,22,DJ Richardson (SA),1991-1998,122,121,165,148,17,148,0,5 (5ct 0st),1.3630000000000002
523,23,RT Ponting (AUS/ICC),1995-2012,375,372,160,160,0,0,160,3 (3ct 0st),0.43
524,24,M Azharuddin (INDIA),1985-2000,334,332,156,156,0,0,156,4 (4ct 0st),0.469
525,25,NR Mongia (INDIA),1994-2000,140,139,154,110,44,110,0,5 (4ct 1st),1.107
526,26,BRM Taylor (ZIM),2004-2019,193,193,154,125,29,96,29,5 (5ct 0st),0.797
527,27,T Taibu (Afr/ZIM),2001-2012,150,150,147,114,33,112,2,4 (4ct 0st),0.98
528,28,AC Parore (NZ),1992-2002,179,178,141,116,25,111,5,5 (3ct 2st),0.792
529,29,Sarfaraz Ahmed (PAK),2007-2019,116,114,140,116,24,116,0,6 (6ct 0st),1.228
530,30,SR Tendulkar (INDIA),1989-2012,463,456,140,140,0,0,140,4 (4ct 0st),0.307
531,31,LRPL Taylor (NZ),2006-2019,228,224,137,137,0,0,137,4 (4ct 0st),0.611
532,32,Younis Khan (PAK),2000-2015,265,260,135,135,0,5,130,4 (4ct 0st),0.519
533,33,SP Fleming (ICC/NZ),1994-2007,280,276,133,133,0,0,133,4 (4ct 0st),0.481
534,34,JH Kallis (Afr/ICC/SA),1996-2014,328,324,131,131,0,0,131,3 (3ct 0st),0.4039999999999999
535,35,M Muralitharan (Asia/ICC/SL),1993-2011,350,347,130,130,0,0,130,3 (3ct 0st),0.374
536,36,AR Border (AUS),1979-1994,273,270,127,127,0,0,127,3 (3ct 0st),0.47
537,37,Shahid Afridi (Asia/ICC/PAK),1996-2015,398,392,127,127,0,0,127,2 (2ct 0st),0.3229999999999999
538,38,Khaled Mashud (BDESH),1995-2006,126,126,126,91,35,91,0,5 (3ct 2st),1.0
539,39,TM Dilshan (SL),1999-2016,330,325,124,123,1,5,118,3 (3ct 0st),0.381
540,40,CH Gayle (ICC/WI),1999-2019,301,294,124,124,0,0,124,3 (3ct 0st),0.421
541,41,V Kohli (INDIA),2008-2019,242,240,124,124,0,0,124,3 (3ct 0st),0.516
542,42,RW Marsh (AUS),1971-1984,92,92,124,120,4,120,0,5 (5ct 0st),1.347
543,43,ST Jayasuriya (Asia/SL),1989-2011,445,441,123,123,0,0,123,3 (3ct 0st),0.278
544,44,CL Hooper (WI),1987-2003,227,225,120,120,0,0,120,4 (4ct 0st),0.5329999999999999
545,45,BC Lara (ICC/WI),1990-2007,299,296,120,120,0,0,120,3 (3ct 0st),0.405
546,46,L Ronchi (AUS/NZ),2008-2017,85,83,117,105,12,105,0,4 (4ct 0st),1.409
547,47,MS Wade (AUS),2012-2017,94,94,117,108,9,108,0,5 (5ct 0st),1.244
548,48,Inzamam-ul-Haq (Asia/PAK),1991-2007,378,373,113,113,0,0,113,3 (3ct 0st),0.302
549,49,SR Waugh (AUS),1986-2002,325,324,111,111,0,0,111,3 (3ct 0st),0.342
550,0,KC Sangakkara (Asia/ICC/SL),2000-2015,404,397,501,402,99,383,19,5 (4ct 1st),1.261
551,1,AC Gilchrist (AUS/ICC),1996-2008,287,286,472,417,55,417,0,6 (6ct 0st),1.65
552,2,MS Dhoni (Asia/INDIA),2004-2019,350,345,444,321,123,321,0,6 (5ct 1st),1.286
553,3,MV Boucher (Afr/SA),1998-2011,295,291,425,403,22,402,1,6 (6ct 0st),1.46
554,4,Moin Khan (PAK),1990-2004,219,217,287,214,73,214,0,5 (5ct 0st),1.3219999999999998
555,5,BB McCullum (NZ),2002-2016,260,257,277,262,15,227,35,5 (5ct 0st),1.077
556,6,IA Healy (AUS),1988-1997,168,168,233,194,39,194,0,4 (4ct 0st),1.386
557,7,Mushfiqur Rahim (BDESH),2006-2019,216,215,225,181,44,179,2,5 (5ct 0st),1.046
558,8,Rashid Latif (PAK),1992-2003,166,164,220,182,38,182,0,5 (5ct 0st),1.341
559,9,DPMD Jayawardene (Asia/SL),1998-2015,448,443,218,218,0,0,218,4 (4ct 0st),0.492
560,10,R Dravid (Asia/ICC/INDIA),1996-2011,344,341,210,196,14,72,124,4 (4ct 0st),0.615
561,11,RS Kaluwitharana (SL),1990-2004,189,188,207,132,75,131,1,5 (4ct 1st),1.101
562,12,PJL Dujon (WI),1981-1991,169,168,204,183,21,183,0,4 (4ct 0st),1.214
563,13,JC Buttler (ENG),2012-2019,142,138,202,171,31,171,0,6 (6ct 0st),1.463
564,14,RD Jacobs (WI),1996-2004,147,145,189,160,29,160,0,6 (5ct 1st),1.3030000000000002
565,15,Kamran Akmal (PAK),2002-2017,157,154,188,157,31,156,1,5 (4ct 1st),1.22
566,16,D Ramdin (WI),2005-2016,139,137,188,181,7,181,0,5 (5ct 0st),1.372
567,17,AB de Villiers (Afr/SA),2005-2018,228,223,181,176,5,93,83,5 (5ct 0st),0.8109999999999999
568,18,BJ Haddin (AUS),2001-2015,126,124,181,170,11,170,0,5 (5ct 0st),1.459
569,19,AJ Stewart (ENG),1989-2003,170,169,174,159,15,148,11,6 (6ct 0st),1.029
570,20,A Flower (ZIM),1992-2003,213,212,173,141,32,133,8,5 (5ct 0st),0.816
571,21,Q de Kock (SA),2013-2019,115,111,166,158,8,158,0,6 (5ct 1st),1.495
572,22,DJ Richardson (SA),1991-1998,122,121,165,148,17,148,0,5 (5ct 0st),1.3630000000000002
573,23,RT Ponting (AUS/ICC),1995-2012,375,372,160,160,0,0,160,3 (3ct 0st),0.43
574,24,M Azharuddin (INDIA),1985-2000,334,332,156,156,0,0,156,4 (4ct 0st),0.469
575,25,NR Mongia (INDIA),1994-2000,140,139,154,110,44,110,0,5 (4ct 1st),1.107
576,26,BRM Taylor (ZIM),2004-2019,193,193,154,125,29,96,29,5 (5ct 0st),0.797
577,27,T Taibu (Afr/ZIM),2001-2012,150,150,147,114,33,112,2,4 (4ct 0st),0.98
578,28,AC Parore (NZ),1992-2002,179,178,141,116,25,111,5,5 (3ct 2st),0.792
579,29,Sarfaraz Ahmed (PAK),2007-2019,116,114,140,116,24,116,0,6 (6ct 0st),1.228
580,30,SR Tendulkar (INDIA),1989-2012,463,456,140,140,0,0,140,4 (4ct 0st),0.307
581,31,LRPL Taylor (NZ),2006-2019,228,224,137,137,0,0,137,4 (4ct 0st),0.611
582,32,Younis Khan (PAK),2000-2015,265,260,135,135,0,5,130,4 (4ct 0st),0.519
583,33,SP Fleming (ICC/NZ),1994-2007,280,276,133,133,0,0,133,4 (4ct 0st),0.481
584,34,JH Kallis (Afr/ICC/SA),1996-2014,328,324,131,131,0,0,131,3 (3ct 0st),0.4039999999999999
585,35,M Muralitharan (Asia/ICC/SL),1993-2011,350,347,130,130,0,0,130,3 (3ct 0st),0.374
586,36,AR Border (AUS),1979-1994,273,270,127,127,0,0,127,3 (3ct 0st),0.47
587,37,Shahid Afridi (Asia/ICC/PAK),1996-2015,398,392,127,127,0,0,127,2 (2ct 0st),0.3229999999999999
588,38,Khaled Mashud (BDESH),1995-2006,126,126,126,91,35,91,0,5 (3ct 2st),1.0
589,39,TM Dilshan (SL),1999-2016,330,325,124,123,1,5,118,3 (3ct 0st),0.381
590,40,CH Gayle (ICC/WI),1999-2019,301,294,124,124,0,0,124,3 (3ct 0st),0.421
591,41,V Kohli (INDIA),2008-2019,242,240,124,124,0,0,124,3 (3ct 0st),0.516
592,42,RW Marsh (AUS),1971-1984,92,92,124,120,4,120,0,5 (5ct 0st),1.347
593,43,ST Jayasuriya (Asia/SL),1989-2011,445,441,123,123,0,0,123,3 (3ct 0st),0.278
594,44,CL Hooper (WI),1987-2003,227,225,120,120,0,0,120,4 (4ct 0st),0.5329999999999999
595,45,BC Lara (ICC/WI),1990-2007,299,296,120,120,0,0,120,3 (3ct 0st),0.405
596,46,L Ronchi (AUS/NZ),2008-2017,85,83,117,105,12,105,0,4 (4ct 0st),1.409
597,47,MS Wade (AUS),2012-2017,94,94,117,108,9,108,0,5 (5ct 0st),1.244
598,48,Inzamam-ul-Haq (Asia/PAK),1991-2007,378,373,113,113,0,0,113,3 (3ct 0st),0.302
599,49,SR Waugh (AUS),1986-2002,325,324,111,111,0,0,111,3 (3ct 0st),0.342
600,0,KC Sangakkara (Asia/ICC/SL),2000-2015,404,397,501,402,99,383,19,5 (4ct 1st),1.261
601,1,AC Gilchrist (AUS/ICC),1996-2008,287,286,472,417,55,417,0,6 (6ct 0st),1.65
602,2,MS Dhoni (Asia/INDIA),2004-2019,350,345,444,321,123,321,0,6 (5ct 1st),1.286
603,3,MV Boucher (Afr/SA),1998-2011,295,291,425,403,22,402,1,6 (6ct 0st),1.46
604,4,Moin Khan (PAK),1990-2004,219,217,287,214,73,214,0,5 (5ct 0st),1.3219999999999998
605,5,BB McCullum (NZ),2002-2016,260,257,277,262,15,227,35,5 (5ct 0st),1.077
606,6,IA Healy (AUS),1988-1997,168,168,233,194,39,194,0,4 (4ct 0st),1.386
607,7,Mushfiqur Rahim (BDESH),2006-2019,216,215,225,181,44,179,2,5 (5ct 0st),1.046
608,8,Rashid Latif (PAK),1992-2003,166,164,220,182,38,182,0,5 (5ct 0st),1.341
609,9,DPMD Jayawardene (Asia/SL),1998-2015,448,443,218,218,0,0,218,4 (4ct 0st),0.492
610,10,R Dravid (Asia/ICC/INDIA),1996-2011,344,341,210,196,14,72,124,4 (4ct 0st),0.615
611,11,RS Kaluwitharana (SL),1990-2004,189,188,207,132,75,131,1,5 (4ct 1st),1.101
612,12,PJL Dujon (WI),1981-1991,169,168,204,183,21,183,0,4 (4ct 0st),1.214
613,13,JC Buttler (ENG),2012-2019,142,138,202,171,31,171,0,6 (6ct 0st),1.463
614,14,RD Jacobs (WI),1996-2004,147,145,189,160,29,160,0,6 (5ct 1st),1.3030000000000002
615,15,Kamran Akmal (PAK),2002-2017,157,154,188,157,31,156,1,5 (4ct 1st),1.22
616,16,D Ramdin (WI),2005-2016,139,137,188,181,7,181,0,5 (5ct 0st),1.372
617,17,AB de Villiers (Afr/SA),2005-2018,228,223,181,176,5,93,83,5 (5ct 0st),0.8109999999999999
618,18,BJ Haddin (AUS),2001-2015,126,124,181,170,11,170,0,5 (5ct 0st),1.459
619,19,AJ Stewart (ENG),1989-2003,170,169,174,159,15,148,11,6 (6ct 0st),1.029
620,20,A Flower (ZIM),1992-2003,213,212,173,141,32,133,8,5 (5ct 0st),0.816
621,21,Q de Kock (SA),2013-2019,115,111,166,158,8,158,0,6 (5ct 1st),1.495
622,22,DJ Richardson (SA),1991-1998,122,121,165,148,17,148,0,5 (5ct 0st),1.3630000000000002
623,23,RT Ponting (AUS/ICC),1995-2012,375,372,160,160,0,0,160,3 (3ct 0st),0.43
624,24,M Azharuddin (INDIA),1985-2000,334,332,156,156,0,0,156,4 (4ct 0st),0.469
625,25,NR Mongia (INDIA),1994-2000,140,139,154,110,44,110,0,5 (4ct 1st),1.107
626,26,BRM Taylor (ZIM),2004-2019,193,193,154,125,29,96,29,5 (5ct 0st),0.797
627,27,T Taibu (Afr/ZIM),2001-2012,150,150,147,114,33,112,2,4 (4ct 0st),0.98
628,28,AC Parore (NZ),1992-2002,179,178,141,116,25,111,5,5 (3ct 2st),0.792
629,29,Sarfaraz Ahmed (PAK),2007-2019,116,114,140,116,24,116,0,6 (6ct 0st),1.228
630,30,SR Tendulkar (INDIA),1989-2012,463,456,140,140,0,0,140,4 (4ct 0st),0.307
631,31,LRPL Taylor (NZ),2006-2019,228,224,137,137,0,0,137,4 (4ct 0st),0.611
632,32,Younis Khan (PAK),2000-2015,265,260,135,135,0,5,130,4 (4ct 0st),0.519
633,33,SP Fleming (ICC/NZ),1994-2007,280,276,133,133,0,0,133,4 (4ct 0st),0.481
634,34,JH Kallis (Afr/ICC/SA),1996-2014,328,324,131,131,0,0,131,3 (3ct 0st),0.4039999999999999
635,35,M Muralitharan (Asia/ICC/SL),1993-2011,350,347,130,130,0,0,130,3 (3ct 0st),0.374
636,36,AR Border (AUS),1979-1994,273,270,127,127,0,0,127,3 (3ct 0st),0.47
637,37,Shahid Afridi (Asia/ICC/PAK),1996-2015,398,392,127,127,0,0,127,2 (2ct 0st),0.3229999999999999
638,38,Khaled Mashud (BDESH),1995-2006,126,126,126,91,35,91,0,5 (3ct 2st),1.0
639,39,TM Dilshan (SL),1999-2016,330,325,124,123,1,5,118,3 (3ct 0st),0.381
640,40,CH Gayle (ICC/WI),1999-2019,301,294,124,124,0,0,124,3 (3ct 0st),0.421
641,41,V Kohli (INDIA),2008-2019,242,240,124,124,0,0,124,3 (3ct 0st),0.516
642,42,RW Marsh (AUS),1971-1984,92,92,124,120,4,120,0,5 (5ct 0st),1.347
643,43,ST Jayasuriya (Asia/SL),1989-2011,445,441,123,123,0,0,123,3 (3ct 0st),0.278
644,44,CL Hooper (WI),1987-2003,227,225,120,120,0,0,120,4 (4ct 0st),0.5329999999999999
645,45,BC Lara (ICC/WI),1990-2007,299,296,120,120,0,0,120,3 (3ct 0st),0.405
646,46,L Ronchi (AUS/NZ),2008-2017,85,83,117,105,12,105,0,4 (4ct 0st),1.409
647,47,MS Wade (AUS),2012-2017,94,94,117,108,9,108,0,5 (5ct 0st),1.244
648,48,Inzamam-ul-Haq (Asia/PAK),1991-2007,378,373,113,113,0,0,113,3 (3ct 0st),0.302
649,49,SR Waugh (AUS),1986-2002,325,324,111,111,0,0,111,3 (3ct 0st),0.342
650,0,KC Sangakkara (Asia/ICC/SL),2000-2015,404,397,501,402,99,383,19,5 (4ct 1st),1.261
651,1,AC Gilchrist (AUS/ICC),1996-2008,287,286,472,417,55,417,0,6 (6ct 0st),1.65
652,2,MS Dhoni (Asia/INDIA),2004-2019,350,345,444,321,123,321,0,6 (5ct 1st),1.286
653,3,MV Boucher (Afr/SA),1998-2011,295,291,425,403,22,402,1,6 (6ct 0st),1.46
654,4,Moin Khan (PAK),1990-2004,219,217,287,214,73,214,0,5 (5ct 0st),1.3219999999999998
655,5,BB McCullum (NZ),2002-2016,260,257,277,262,15,227,35,5 (5ct 0st),1.077
656,6,IA Healy (AUS),1988-1997,168,168,233,194,39,194,0,4 (4ct 0st),1.386
657,7,Mushfiqur Rahim (BDESH),2006-2019,216,215,225,181,44,179,2,5 (5ct 0st),1.046
658,8,Rashid Latif (PAK),1992-2003,166,164,220,182,38,182,0,5 (5ct 0st),1.341
659,9,DPMD Jayawardene (Asia/SL),1998-2015,448,443,218,218,0,0,218,4 (4ct 0st),0.492
660,10,R Dravid (Asia/ICC/INDIA),1996-2011,344,341,210,196,14,72,124,4 (4ct 0st),0.615
661,11,RS Kaluwitharana (SL),1990-2004,189,188,207,132,75,131,1,5 (4ct 1st),1.101
662,12,PJL Dujon (WI),1981-1991,169,168,204,183,21,183,0,4 (4ct 0st),1.214
663,13,JC Buttler (ENG),2012-2019,142,138,202,171,31,171,0,6 (6ct 0st),1.463
664,14,RD Jacobs (WI),1996-2004,147,145,189,160,29,160,0,6 (5ct 1st),1.3030000000000002
665,15,Kamran Akmal (PAK),2002-2017,157,154,188,157,31,156,1,5 (4ct 1st),1.22
666,16,D Ramdin (WI),2005-2016,139,137,188,181,7,181,0,5 (5ct 0st),1.372
667,17,AB de Villiers (Afr/SA),2005-2018,228,223,181,176,5,93,83,5 (5ct 0st),0.8109999999999999
668,18,BJ Haddin (AUS),2001-2015,126,124,181,170,11,170,0,5 (5ct 0st),1.459
669,19,AJ Stewart (ENG),1989-2003,170,169,174,159,15,148,11,6 (6ct 0st),1.029
670,20,A Flower (ZIM),1992-2003,213,212,173,141,32,133,8,5 (5ct 0st),0.816
671,21,Q de Kock (SA),2013-2019,115,111,166,158,8,158,0,6 (5ct 1st),1.495
672,22,DJ Richardson (SA),1991-1998,122,121,165,148,17,148,0,5 (5ct 0st),1.3630000000000002
673,23,RT Ponting (AUS/ICC),1995-2012,375,372,160,160,0,0,160,3 (3ct 0st),0.43
674,24,M Azharuddin (INDIA),1985-2000,334,332,156,156,0,0,156,4 (4ct 0st),0.469
675,25,NR Mongia (INDIA),1994-2000,140,139,154,110,44,110,0,5 (4ct 1st),1.107
676,26,BRM Taylor (ZIM),2004-2019,193,193,154,125,29,96,29,5 (5ct 0st),0.797
677,27,T Taibu (Afr/ZIM),2001-2012,150,150,147,114,33,112,2,4 (4ct 0st),0.98
678,28,AC Parore (NZ),1992-2002,179,178,141,116,25,111,5,5 (3ct 2st),0.792
679,29,Sarfaraz Ahmed (PAK),2007-2019,116,114,140,116,24,116,0,6 (6ct 0st),1.228
680,30,SR Tendulkar (INDIA),1989-2012,463,456,140,140,0,0,140,4 (4ct 0st),0.307
681,31,LRPL Taylor (NZ),2006-2019,228,224,137,137,0,0,137,4 (4ct 0st),0.611
682,32,Younis Khan (PAK),2000-2015,265,260,135,135,0,5,130,4 (4ct 0st),0.519
683,33,SP Fleming (ICC/NZ),1994-2007,280,276,133,133,0,0,133,4 (4ct 0st),0.481
684,34,JH Kallis (Afr/ICC/SA),1996-2014,328,324,131,131,0,0,131,3 (3ct 0st),0.4039999999999999
685,35,M Muralitharan (Asia/ICC/SL),1993-2011,350,347,130,130,0,0,130,3 (3ct 0st),0.374
686,36,AR Border (AUS),1979-1994,273,270,127,127,0,0,127,3 (3ct 0st),0.47
687,37,Shahid Afridi (Asia/ICC/PAK),1996-2015,398,392,127,127,0,0,127,2 (2ct 0st),0.3229999999999999
688,38,Khaled Mashud (BDESH),1995-2006,126,126,126,91,35,91,0,5 (3ct 2st),1.0
689,39,TM Dilshan (SL),1999-2016,330,325,124,123,1,5,118,3 (3ct 0st),0.381
690,40,CH Gayle (ICC/WI),1999-2019,301,294,124,124,0,0,124,3 (3ct 0st),0.421
691,41,V Kohli (INDIA),2008-2019,242,240,124,124,0,0,124,3 (3ct 0st),0.516
692,42,RW Marsh (AUS),1971-1984,92,92,124,120,4,120,0,5 (5ct 0st),1.347
693,43,ST Jayasuriya (Asia/SL),1989-2011,445,441,123,123,0,0,123,3 (3ct 0st),0.278
694,44,CL Hooper (WI),1987-2003,227,225,120,120,0,0,120,4 (4ct 0st),0.5329999999999999
695,45,BC Lara (ICC/WI),1990-2007,299,296,120,120,0,0,120,3 (3ct 0st),0.405
696,46,L Ronchi (AUS/NZ),2008-2017,85,83,117,105,12,105,0,4 (4ct 0st),1.409
697,47,MS Wade (AUS),2012-2017,94,94,117,108,9,108,0,5 (5ct 0st),1.244
698,48,Inzamam-ul-Haq (Asia/PAK),1991-2007,378,373,113,113,0,0,113,3 (3ct 0st),0.302
699,49,SR Waugh (AUS),1986-2002,325,324,111,111,0,0,111,3 (3ct 0st),0.342
700,0,KC Sangakkara (Asia/ICC/SL),2000-2015,404,397,501,402,99,383,19,5 (4ct 1st),1.261
701,1,AC Gilchrist (AUS/ICC),1996-2008,287,286,472,417,55,417,0,6 (6ct 0st),1.65
702,2,MS Dhoni (Asia/INDIA),2004-2019,350,345,444,321,123,321,0,6 (5ct 1st),1.286
703,3,MV Boucher (Afr/SA),1998-2011,295,291,425,403,22,402,1,6 (6ct 0st),1.46
704,4,Moin Khan (PAK),1990-2004,219,217,287,214,73,214,0,5 (5ct 0st),1.3219999999999998
705,5,BB McCullum (NZ),2002-2016,260,257,277,262,15,227,35,5 (5ct 0st),1.077
706,6,IA Healy (AUS),1988-1997,168,168,233,194,39,194,0,4 (4ct 0st),1.386
707,7,Mushfiqur Rahim (BDESH),2006-2019,216,215,225,181,44,179,2,5 (5ct 0st),1.046
708,8,Rashid Latif (PAK),1992-2003,166,164,220,182,38,182,0,5 (5ct 0st),1.341
709,9,DPMD Jayawardene (Asia/SL),1998-2015,448,443,218,218,0,0,218,4 (4ct 0st),0.492
710,10,R Dravid (Asia/ICC/INDIA),1996-2011,344,341,210,196,14,72,124,4 (4ct 0st),0.615
711,11,RS Kaluwitharana (SL),1990-2004,189,188,207,132,75,131,1,5 (4ct 1st),1.101
712,12,PJL Dujon (WI),1981-1991,169,168,204,183,21,183,0,4 (4ct 0st),1.214
713,13,JC Buttler (ENG),2012-2019,142,138,202,171,31,171,0,6 (6ct 0st),1.463
714,14,RD Jacobs (WI),1996-2004,147,145,189,160,29,160,0,6 (5ct 1st),1.3030000000000002
715,15,Kamran Akmal (PAK),2002-2017,157,154,188,157,31,156,1,5 (4ct 1st),1.22
716,16,D Ramdin (WI),2005-2016,139,137,188,181,7,181,0,5 (5ct 0st),1.372
717,17,AB de Villiers (Afr/SA),2005-2018,228,223,181,176,5,93,83,5 (5ct 0st),0.8109999999999999
718,18,BJ Haddin (AUS),2001-2015,126,124,181,170,11,170,0,5 (5ct 0st),1.459
719,19,AJ Stewart (ENG),1989-2003,170,169,174,159,15,148,11,6 (6ct 0st),1.029
720,20,A Flower (ZIM),1992-2003,213,212,173,141,32,133,8,5 (5ct 0st),0.816
721,21,Q de Kock (SA),2013-2019,115,111,166,158,8,158,0,6 (5ct 1st),1.495
722,22,DJ Richardson (SA),1991-1998,122,121,165,148,17,148,0,5 (5ct 0st),1.3630000000000002
723,23,RT Ponting (AUS/ICC),1995-2012,375,372,160,160,0,0,160,3 (3ct 0st),0.43
724,24,M Azharuddin (INDIA),1985-2000,334,332,156,156,0,0,156,4 (4ct 0st),0.469
725,25,NR Mongia (INDIA),1994-2000,140,139,154,110,44,110,0,5 (4ct 1st),1.107
726,26,BRM Taylor (ZIM),2004-2019,193,193,154,125,29,96,29,5 (5ct 0st),0.797
727,27,T Taibu (Afr/ZIM),2001-2012,150,150,147,114,33,112,2,4 (4ct 0st),0.98
728,28,AC Parore (NZ),1992-2002,179,178,141,116,25,111,5,5 (3ct 2st),0.792
729,29,Sarfaraz Ahmed (PAK),2007-2019,116,114,140,116,24,116,0,6 (6ct 0st),1.228
730,30,SR Tendulkar (INDIA),1989-2012,463,456,140,140,0,0,140,4 (4ct 0st),0.307
731,31,LRPL Taylor (NZ),2006-2019,228,224,137,137,0,0,137,4 (4ct 0st),0.611
732,32,Younis Khan (PAK),2000-2015,265,260,135,135,0,5,130,4 (4ct 0st),0.519
733,33,SP Fleming (ICC/NZ),1994-2007,280,276,133,133,0,0,133,4 (4ct 0st),0.481
734,34,JH Kallis (Afr/ICC/SA),1996-2014,328,324,131,131,0,0,131,3 (3ct 0st),0.4039999999999999
735,35,M Muralitharan (Asia/ICC/SL),1993-2011,350,347,130,130,0,0,130,3 (3ct 0st),0.374
736,36,AR Border (AUS),1979-1994,273,270,127,127,0,0,127,3 (3ct 0st),0.47
737,37,Shahid Afridi (Asia/ICC/PAK),1996-2015,398,392,127,127,0,0,127,2 (2ct 0st),0.3229999999999999
738,38,Khaled Mashud (BDESH),1995-2006,126,126,126,91,35,91,0,5 (3ct 2st),1.0
739,39,TM Dilshan (SL),1999-2016,330,325,124,123,1,5,118,3 (3ct 0st),0.381
740,40,CH Gayle (ICC/WI),1999-2019,301,294,124,124,0,0,124,3 (3ct 0st),0.421
741,41,V Kohli (INDIA),2008-2019,242,240,124,124,0,0,124,3 (3ct 0st),0.516
742,42,RW Marsh (AUS),1971-1984,92,92,124,120,4,120,0,5 (5ct 0st),1.347
743,43,ST Jayasuriya (Asia/SL),1989-2011,445,441,123,123,0,0,123,3 (3ct 0st),0.278
744,44,CL Hooper (WI),1987-2003,227,225,120,120,0,0,120,4 (4ct 0st),0.5329999999999999
745,45,BC Lara (ICC/WI),1990-2007,299,296,120,120,0,0,120,3 (3ct 0st),0.405
746,46,L Ronchi (AUS/NZ),2008-2017,85,83,117,105,12,105,0,4 (4ct 0st),1.409
747,47,MS Wade (AUS),2012-2017,94,94,117,108,9,108,0,5 (5ct 0st),1.244
748,48,Inzamam-ul-Haq (Asia/PAK),1991-2007,378,373,113,113,0,0,113,3 (3ct 0st),0.302
749,49,SR Waugh (AUS),1986-2002,325,324,111,111,0,0,111,3 (3ct 0st),0.342
750,0,KC Sangakkara (Asia/ICC/SL),2000-2015,404,397,501,402,99,383,19,5 (4ct 1st),1.261
751,1,AC Gilchrist (AUS/ICC),1996-2008,287,286,472,417,55,417,0,6 (6ct 0st),1.65
752,2,MS Dhoni (Asia/INDIA),2004-2019,350,345,444,321,123,321,0,6 (5ct 1st),1.286
753,3,MV Boucher (Afr/SA),1998-2011,295,291,425,403,22,402,1,6 (6ct 0st),1.46
754,4,Moin Khan (PAK),1990-2004,219,217,287,214,73,214,0,5 (5ct 0st),1.3219999999999998
755,5,BB McCullum (NZ),2002-2016,260,257,277,262,15,227,35,5 (5ct 0st),1.077
756,6,IA Healy (AUS),1988-1997,168,168,233,194,39,194,0,4 (4ct 0st),1.386
757,7,Mushfiqur Rahim (BDESH),2006-2019,216,215,225,181,44,179,2,5 (5ct 0st),1.046
758,8,Rashid Latif (PAK),1992-2003,166,164,220,182,38,182,0,5 (5ct 0st),1.341
759,9,DPMD Jayawardene (Asia/SL),1998-2015,448,443,218,218,0,0,218,4 (4ct 0st),0.492
760,10,R Dravid (Asia/ICC/INDIA),1996-2011,344,341,210,196,14,72,124,4 (4ct 0st),0.615
761,11,RS Kaluwitharana (SL),1990-2004,189,188,207,132,75,131,1,5 (4ct 1st),1.101
762,12,PJL Dujon (WI),1981-1991,169,168,204,183,21,183,0,4 (4ct 0st),1.214
763,13,JC Buttler (ENG),2012-2019,142,138,202,171,31,171,0,6 (6ct 0st),1.463
764,14,RD Jacobs (WI),1996-2004,147,145,189,160,29,160,0,6 (5ct 1st),1.3030000000000002
765,15,Kamran Akmal (PAK),2002-2017,157,154,188,157,31,156,1,5 (4ct 1st),1.22
766,16,D Ramdin (WI),2005-2016,139,137,188,181,7,181,0,5 (5ct 0st),1.372
767,17,AB de Villiers (Afr/SA),2005-2018,228,223,181,176,5,93,83,5 (5ct 0st),0.8109999999999999
768,18,BJ Haddin (AUS),2001-2015,126,124,181,170,11,170,0,5 (5ct 0st),1.459
769,19,AJ Stewart (ENG),1989-2003,170,169,174,159,15,148,11,6 (6ct 0st),1.029
770,20,A Flower (ZIM),1992-2003,213,212,173,141,32,133,8,5 (5ct 0st),0.816
771,21,Q de Kock (SA),2013-2019,115,111,166,158,8,158,0,6 (5ct 1st),1.495
772,22,DJ Richardson (SA),1991-1998,122,121,165,148,17,148,0,5 (5ct 0st),1.3630000000000002
773,23,RT Ponting (AUS/ICC),1995-2012,375,372,160,160,0,0,160,3 (3ct 0st),0.43
774,24,M Azharuddin (INDIA),1985-2000,334,332,156,156,0,0,156,4 (4ct 0st),0.469
775,25,NR Mongia (INDIA),1994-2000,140,139,154,110,44,110,0,5 (4ct 1st),1.107
776,26,BRM Taylor (ZIM),2004-2019,193,193,154,125,29,96,29,5 (5ct 0st),0.797
777,27,T Taibu (Afr/ZIM),2001-2012,150,150,147,114,33,112,2,4 (4ct 0st),0.98
778,28,AC Parore (NZ),1992-2002,179,178,141,116,25,111,5,5 (3ct 2st),0.792
779,29,Sarfaraz Ahmed (PAK),2007-2019,116,114,140,116,24,116,0,6 (6ct 0st),1.228
780,30,SR Tendulkar (INDIA),1989-2012,463,456,140,140,0,0,140,4 (4ct 0st),0.307
781,31,LRPL Taylor (NZ),2006-2019,228,224,137,137,0,0,137,4 (4ct 0st),0.611
782,32,Younis Khan (PAK),2000-2015,265,260,135,135,0,5,130,4 (4ct 0st),0.519
783,33,SP Fleming (ICC/NZ),1994-2007,280,276,133,133,0,0,133,4 (4ct 0st),0.481
784,34,JH Kallis (Afr/ICC/SA),1996-2014,328,324,131,131,0,0,131,3 (3ct 0st),0.4039999999999999
785,35,M Muralitharan (Asia/ICC/SL),1993-2011,350,347,130,130,0,0,130,3 (3ct 0st),0.374
786,36,AR Border (AUS),1979-1994,273,270,127,127,0,0,127,3 (3ct 0st),0.47
787,37,Shahid Afridi (Asia/ICC/PAK),1996-2015,398,392,127,127,0,0,127,2 (2ct 0st),0.3229999999999999
788,38,Khaled Mashud (BDESH),1995-2006,126,126,126,91,35,91,0,5 (3ct 2st),1.0
789,39,TM Dilshan (SL),1999-2016,330,325,124,123,1,5,118,3 (3ct 0st),0.381
790,40,CH Gayle (ICC/WI),1999-2019,301,294,124,124,0,0,124,3 (3ct 0st),0.421
791,41,V Kohli (INDIA),2008-2019,242,240,124,124,0,0,124,3 (3ct 0st),0.516
792,42,RW Marsh (AUS),1971-1984,92,92,124,120,4,120,0,5 (5ct 0st),1.347
793,43,ST Jayasuriya (Asia/SL),1989-2011,445,441,123,123,0,0,123,3 (3ct 0st),0.278
794,44,CL Hooper (WI),1987-2003,227,225,120,120,0,0,120,4 (4ct 0st),0.5329999999999999
795,45,BC Lara (ICC/WI),1990-2007,299,296,120,120,0,0,120,3 (3ct 0st),0.405
796,46,L Ronchi (AUS/NZ),2008-2017,85,83,117,105,12,105,0,4 (4ct 0st),1.409
797,47,MS Wade (AUS),2012-2017,94,94,117,108,9,108,0,5 (5ct 0st),1.244
798,48,Inzamam-ul-Haq (Asia/PAK),1991-2007,378,373,113,113,0,0,113,3 (3ct 0st),0.302
799,49,SR Waugh (AUS),1986-2002,325,324,111,111,0,0,111,3 (3ct 0st),0.342
800,0,KC Sangakkara (Asia/ICC/SL),2000-2015,404,397,501,402,99,383,19,5 (4ct 1st),1.261
801,1,AC Gilchrist (AUS/ICC),1996-2008,287,286,472,417,55,417,0,6 (6ct 0st),1.65
802,2,MS Dhoni (Asia/INDIA),2004-2019,350,345,444,321,123,321,0,6 (5ct 1st),1.286
803,3,MV Boucher (Afr/SA),1998-2011,295,291,425,403,22,402,1,6 (6ct 0st),1.46
804,4,Moin Khan (PAK),1990-2004,219,217,287,214,73,214,0,5 (5ct 0st),1.3219999999999998
805,5,BB McCullum (NZ),2002-2016,260,257,277,262,15,227,35,5 (5ct 0st),1.077
806,6,IA Healy (AUS),1988-1997,168,168,233,194,39,194,0,4 (4ct 0st),1.386
807,7,Mushfiqur Rahim (BDESH),2006-2019,216,215,225,181,44,179,2,5 (5ct 0st),1.046
808,8,Rashid Latif (PAK),1992-2003,166,164,220,182,38,182,0,5 (5ct 0st),1.341
809,9,DPMD Jayawardene (Asia/SL),1998-2015,448,443,218,218,0,0,218,4 (4ct 0st),0.492
810,10,R Dravid (Asia/ICC/INDIA),1996-2011,344,341,210,196,14,72,124,4 (4ct 0st),0.615
811,11,RS Kaluwitharana (SL),1990-2004,189,188,207,132,75,131,1,5 (4ct 1st),1.101
812,12,PJL Dujon (WI),1981-1991,169,168,204,183,21,183,0,4 (4ct 0st),1.214
813,13,JC Buttler (ENG),2012-2019,142,138,202,171,31,171,0,6 (6ct 0st),1.463
814,14,RD Jacobs (WI),1996-2004,147,145,189,160,29,160,0,6 (5ct 1st),1.3030000000000002
815,15,Kamran Akmal (PAK),2002-2017,157,154,188,157,31,156,1,5 (4ct 1st),1.22
816,16,D Ramdin (WI),2005-2016,139,137,188,181,7,181,0,5 (5ct 0st),1.372
817,17,AB de Villiers (Afr/SA),2005-2018,228,223,181,176,5,93,83,5 (5ct 0st),0.8109999999999999
818,18,BJ Haddin (AUS),2001-2015,126,124,181,170,11,170,0,5 (5ct 0st),1.459
819,19,AJ Stewart (ENG),1989-2003,170,169,174,159,15,148,11,6 (6ct 0st),1.029
820,20,A Flower (ZIM),1992-2003,213,212,173,141,32,133,8,5 (5ct 0st),0.816
821,21,Q de Kock (SA),2013-2019,115,111,166,158,8,158,0,6 (5ct 1st),1.495
822,22,DJ Richardson (SA),1991-1998,122,121,165,148,17,148,0,5 (5ct 0st),1.3630000000000002
823,23,RT Ponting (AUS/ICC),1995-2012,375,372,160,160,0,0,160,3 (3ct 0st),0.43
824,24,M Azharuddin (INDIA),1985-2000,334,332,156,156,0,0,156,4 (4ct 0st),0.469
825,25,NR Mongia (INDIA),1994-2000,140,139,154,110,44,110,0,5 (4ct 1st),1.107
826,26,BRM Taylor (ZIM),2004-2019,193,193,154,125,29,96,29,5 (5ct 0st),0.797
827,27,T Taibu (Afr/ZIM),2001-2012,150,150,147,114,33,112,2,4 (4ct 0st),0.98
828,28,AC Parore (NZ),1992-2002,179,178,141,116,25,111,5,5 (3ct 2st),0.792
829,29,Sarfaraz Ahmed (PAK),2007-2019,116,114,140,116,24,116,0,6 (6ct 0st),1.228
830,30,SR Tendulkar (INDIA),1989-2012,463,456,140,140,0,0,140,4 (4ct 0st),0.307
831,31,LRPL Taylor (NZ),2006-2019,228,224,137,137,0,0,137,4 (4ct 0st),0.611
832,32,Younis Khan (PAK),2000-2015,265,260,135,135,0,5,130,4 (4ct 0st),0.519
833,33,SP Fleming (ICC/NZ),1994-2007,280,276,133,133,0,0,133,4 (4ct 0st),0.481
834,34,JH Kallis (Afr/ICC/SA),1996-2014,328,324,131,131,0,0,131,3 (3ct 0st),0.4039999999999999
835,35,M Muralitharan (Asia/ICC/SL),1993-2011,350,347,130,130,0,0,130,3 (3ct 0st),0.374
836,36,AR Border (AUS),1979-1994,273,270,127,127,0,0,127,3 (3ct 0st),0.47
837,37,Shahid Afridi (Asia/ICC/PAK),1996-2015,398,392,127,127,0,0,127,2 (2ct 0st),0.3229999999999999
838,38,Khaled Mashud (BDESH),1995-2006,126,126,126,91,35,91,0,5 (3ct 2st),1.0
839,39,TM Dilshan (SL),1999-2016,330,325,124,123,1,5,118,3 (3ct 0st),0.381
840,40,CH Gayle (ICC/WI),1999-2019,301,294,124,124,0,0,124,3 (3ct 0st),0.421
841,41,V Kohli (INDIA),2008-2019,242,240,124,124,0,0,124,3 (3ct 0st),0.516
842,42,RW Marsh (AUS),1971-1984,92,92,124,120,4,120,0,5 (5ct 0st),1.347
843,43,ST Jayasuriya (Asia/SL),1989-2011,445,441,123,123,0,0,123,3 (3ct 0st),0.278
844,44,CL Hooper (WI),1987-2003,227,225,120,120,0,0,120,4 (4ct 0st),0.5329999999999999
845,45,BC Lara (ICC/WI),1990-2007,299,296,120,120,0,0,120,3 (3ct 0st),0.405
846,46,L Ronchi (AUS/NZ),2008-2017,85,83,117,105,12,105,0,4 (4ct 0st),1.409
847,47,MS Wade (AUS),2012-2017,94,94,117,108,9,108,0,5 (5ct 0st),1.244
848,48,Inzamam-ul-Haq (Asia/PAK),1991-2007,378,373,113,113,0,0,113,3 (3ct 0st),0.302
849,49,SR Waugh (AUS),1986-2002,325,324,111,111,0,0,111,3 (3ct 0st),0.342
850,0,KC Sangakkara (Asia/ICC/SL),2000-2015,404,397,501,402,99,383,19,5 (4ct 1st),1.261
851,1,AC Gilchrist (AUS/ICC),1996-2008,287,286,472,417,55,417,0,6 (6ct 0st),1.65
852,2,MS Dhoni (Asia/INDIA),2004-2019,350,345,444,321,123,321,0,6 (5ct 1st),1.286
853,3,MV Boucher (Afr/SA),1998-2011,295,291,425,403,22,402,1,6 (6ct 0st),1.46
854,4,Moin Khan (PAK),1990-2004,219,217,287,214,73,214,0,5 (5ct 0st),1.3219999999999998
855,5,BB McCullum (NZ),2002-2016,260,257,277,262,15,227,35,5 (5ct 0st),1.077
856,6,IA Healy (AUS),1988-1997,168,168,233,194,39,194,0,4 (4ct 0st),1.386
857,7,Mushfiqur Rahim (BDESH),2006-2019,216,215,225,181,44,179,2,5 (5ct 0st),1.046
858,8,Rashid Latif (PAK),1992-2003,166,164,220,182,38,182,0,5 (5ct 0st),1.341
859,9,DPMD Jayawardene (Asia/SL),1998-2015,448,443,218,218,0,0,218,4 (4ct 0st),0.492
860,10,R Dravid (Asia/ICC/INDIA),1996-2011,344,341,210,196,14,72,124,4 (4ct 0st),0.615
861,11,RS Kaluwitharana (SL),1990-2004,189,188,207,132,75,131,1,5 (4ct 1st),1.101
862,12,PJL Dujon (WI),1981-1991,169,168,204,183,21,183,0,4 (4ct 0st),1.214
863,13,JC Buttler (ENG),2012-2019,142,138,202,171,31,171,0,6 (6ct 0st),1.463
864,14,RD Jacobs (WI),1996-2004,147,145,189,160,29,160,0,6 (5ct 1st),1.3030000000000002
865,15,Kamran Akmal (PAK),2002-2017,157,154,188,157,31,156,1,5 (4ct 1st),1.22
866,16,D Ramdin (WI),2005-2016,139,137,188,181,7,181,0,5 (5ct 0st),1.372
867,17,AB de Villiers (Afr/SA),2005-2018,228,223,181,176,5,93,83,5 (5ct 0st),0.8109999999999999
868,18,BJ Haddin (AUS),2001-2015,126,124,181,170,11,170,0,5 (5ct 0st),1.459
869,19,AJ Stewart (ENG),1989-2003,170,169,174,159,15,148,11,6 (6ct 0st),1.029
870,20,A Flower (ZIM),1992-2003,213,212,173,141,32,133,8,5 (5ct 0st),0.816
871,21,Q de Kock (SA),2013-2019,115,111,166,158,8,158,0,6 (5ct 1st),1.495
872,22,DJ Richardson (SA),1991-1998,122,121,165,148,17,148,0,5 (5ct 0st),1.3630000000000002
873,23,RT Ponting (AUS/ICC),1995-2012,375,372,160,160,0,0,160,3 (3ct 0st),0.43
874,24,M Azharuddin (INDIA),1985-2000,334,332,156,156,0,0,156,4 (4ct 0st),0.469
875,25,NR Mongia (INDIA),1994-2000,140,139,154,110,44,110,0,5 (4ct 1st),1.107
876,26,BRM Taylor (ZIM),2004-2019,193,193,154,125,29,96,29,5 (5ct 0st),0.797
877,27,T Taibu (Afr/ZIM),2001-2012,150,150,147,114,33,112,2,4 (4ct 0st),0.98
878,28,AC Parore (NZ),1992-2002,179,178,141,116,25,111,5,5 (3ct 2st),0.792
879,29,Sarfaraz Ahmed (PAK),2007-2019,116,114,140,116,24,116,0,6 (6ct 0st),1.228
880,30,SR Tendulkar (INDIA),1989-2012,463,456,140,140,0,0,140,4 (4ct 0st),0.307
881,31,LRPL Taylor (NZ),2006-2019,228,224,137,137,0,0,137,4 (4ct 0st),0.611
882,32,Younis Khan (PAK),2000-2015,265,260,135,135,0,5,130,4 (4ct 0st),0.519
883,33,SP Fleming (ICC/NZ),1994-2007,280,276,133,133,0,0,133,4 (4ct 0st),0.481
884,34,JH Kallis (Afr/ICC/SA),1996-2014,328,324,131,131,0,0,131,3 (3ct 0st),0.4039999999999999
885,35,M Muralitharan (Asia/ICC/SL),1993-2011,350,347,130,130,0,0,130,3 (3ct 0st),0.374
886,36,AR Border (AUS),1979-1994,273,270,127,127,0,0,127,3 (3ct 0st),0.47
887,37,Shahid Afridi (Asia/ICC/PAK),1996-2015,398,392,127,127,0,0,127,2 (2ct 0st),0.3229999999999999
888,38,Khaled Mashud (BDESH),1995-2006,126,126,126,91,35,91,0,5 (3ct 2st),1.0
889,39,TM Dilshan (SL),1999-2016,330,325,124,123,1,5,118,3 (3ct 0st),0.381
890,40,CH Gayle (ICC/WI),1999-2019,301,294,124,124,0,0,124,3 (3ct 0st),0.421
891,41,V Kohli (INDIA),2008-2019,242,240,124,124,0,0,124,3 (3ct 0st),0.516
892,42,RW Marsh (AUS),1971-1984,92,92,124,120,4,120,0,5 (5ct 0st),1.347
893,43,ST Jayasuriya (Asia/SL),1989-2011,445,441,123,123,0,0,123,3 (3ct 0st),0.278
894,44,CL Hooper (WI),1987-2003,227,225,120,120,0,0,120,4 (4ct 0st),0.5329999999999999
895,45,BC Lara (ICC/WI),1990-2007,299,296,120,120,0,0,120,3 (3ct 0st),0.405
896,46,L Ronchi (AUS/NZ),2008-2017,85,83,117,105,12,105,0,4 (4ct 0st),1.409
897,47,MS Wade (AUS),2012-2017,94,94,117,108,9,108,0,5 (5ct 0st),1.244
898,48,Inzamam-ul-Haq (Asia/PAK),1991-2007,378,373,113,113,0,0,113,3 (3ct 0st),0.302
899,49,SR Waugh (AUS),1986-2002,325,324,111,111,0,0,111,3 (3ct 0st),0.342
900,0,KC Sangakkara (Asia/ICC/SL),2000-2015,404,397,501,402,99,383,19,5 (4ct 1st),1.261
901,1,AC Gilchrist (AUS/ICC),1996-2008,287,286,472,417,55,417,0,6 (6ct 0st),1.65
902,2,MS Dhoni (Asia/INDIA),2004-2019,350,345,444,321,123,321,0,6 (5ct 1st),1.286
903,3,MV Boucher (Afr/SA),1998-2011,295,291,425,403,22,402,1,6 (6ct 0st),1.46
904,4,Moin Khan (PAK),1990-2004,219,217,287,214,73,214,0,5 (5ct 0st),1.3219999999999998
905,5,BB McCullum (NZ),2002-2016,260,257,277,262,15,227,35,5 (5ct 0st),1.077
906,6,IA Healy (AUS),1988-1997,168,168,233,194,39,194,0,4 (4ct 0st),1.386
907,7,Mushfiqur Rahim (BDESH),2006-2019,216,215,225,181,44,179,2,5 (5ct 0st),1.046
908,8,Rashid Latif (PAK),1992-2003,166,164,220,182,38,182,0,5 (5ct 0st),1.341
909,9,DPMD Jayawardene (Asia/SL),1998-2015,448,443,218,218,0,0,218,4 (4ct 0st),0.492
910,10,R Dravid (Asia/ICC/INDIA),1996-2011,344,341,210,196,14,72,124,4 (4ct 0st),0.615
911,11,RS Kaluwitharana (SL),1990-2004,189,188,207,132,75,131,1,5 (4ct 1st),1.101
912,12,PJL Dujon (WI),1981-1991,169,168,204,183,21,183,0,4 (4ct 0st),1.214
913,13,JC Buttler (ENG),2012-2019,142,138,202,171,31,171,0,6 (6ct 0st),1.463
914,14,RD Jacobs (WI),1996-2004,147,145,189,160,29,160,0,6 (5ct 1st),1.3030000000000002
915,15,Kamran Akmal (PAK),2002-2017,157,154,188,157,31,156,1,5 (4ct 1st),1.22
916,16,D Ramdin (WI),2005-2016,139,137,188,181,7,181,0,5 (5ct 0st),1.372
917,17,AB de Villiers (Afr/SA),2005-2018,228,223,181,176,5,93,83,5 (5ct 0st),0.8109999999999999
918,18,BJ Haddin (AUS),2001-2015,126,124,181,170,11,170,0,5 (5ct 0st),1.459
919,19,AJ Stewart (ENG),1989-2003,170,169,174,159,15,148,11,6 (6ct 0st),1.029
920,20,A Flower (ZIM),1992-2003,213,212,173,141,32,133,8,5 (5ct 0st),0.816
921,21,Q de Kock (SA),2013-2019,115,111,166,158,8,158,0,6 (5ct 1st),1.495
922,22,DJ Richardson (SA),1991-1998,122,121,165,148,17,148,0,5 (5ct 0st),1.3630000000000002
923,23,RT Ponting (AUS/ICC),1995-2012,375,372,160,160,0,0,160,3 (3ct 0st),0.43
924,24,M Azharuddin (INDIA),1985-2000,334,332,156,156,0,0,156,4 (4ct 0st),0.469
925,25,NR Mongia (INDIA),1994-2000,140,139,154,110,44,110,0,5 (4ct 1st),1.107
926,26,BRM Taylor (ZIM),2004-2019,193,193,154,125,29,96,29,5 (5ct 0st),0.797
927,27,T Taibu (Afr/ZIM),2001-2012,150,150,147,114,33,112,2,4 (4ct 0st),0.98
928,28,AC Parore (NZ),1992-2002,179,178,141,116,25,111,5,5 (3ct 2st),0.792
929,29,Sarfaraz Ahmed (PAK),2007-2019,116,114,140,116,24,116,0,6 (6ct 0st),1.228
930,30,SR Tendulkar (INDIA),1989-2012,463,456,140,140,0,0,140,4 (4ct 0st),0.307
931,31,LRPL Taylor (NZ),2006-2019,228,224,137,137,0,0,137,4 (4ct 0st),0.611
932,32,Younis Khan (PAK),2000-2015,265,260,135,135,0,5,130,4 (4ct 0st),0.519
933,33,SP Fleming (ICC/NZ),1994-2007,280,276,133,133,0,0,133,4 (4ct 0st),0.481
934,34,JH Kallis (Afr/ICC/SA),1996-2014,328,324,131,131,0,0,131,3 (3ct 0st),0.4039999999999999
935,35,M Muralitharan (Asia/ICC/SL),1993-2011,350,347,130,130,0,0,130,3 (3ct 0st),0.374
936,36,AR Border (AUS),1979-1994,273,270,127,127,0,0,127,3 (3ct 0st),0.47
937,37,Shahid Afridi (Asia/ICC/PAK),1996-2015,398,392,127,127,0,0,127,2 (2ct 0st),0.3229999999999999
938,38,Khaled Mashud (BDESH),1995-2006,126,126,126,91,35,91,0,5 (3ct 2st),1.0
939,39,TM Dilshan (SL),1999-2016,330,325,124,123,1,5,118,3 (3ct 0st),0.381
940,40,CH Gayle (ICC/WI),1999-2019,301,294,124,124,0,0,124,3 (3ct 0st),0.421
941,41,V Kohli (INDIA),2008-2019,242,240,124,124,0,0,124,3 (3ct 0st),0.516
942,42,RW Marsh (AUS),1971-1984,92,92,124,120,4,120,0,5 (5ct 0st),1.347
943,43,ST Jayasuriya (Asia/SL),1989-2011,445,441,123,123,0,0,123,3 (3ct 0st),0.278
944,44,CL Hooper (WI),1987-2003,227,225,120,120,0,0,120,4 (4ct 0st),0.5329999999999999
945,45,BC Lara (ICC/WI),1990-2007,299,296,120,120,0,0,120,3 (3ct 0st),0.405
946,46,L Ronchi (AUS/NZ),2008-2017,85,83,117,105,12,105,0,4 (4ct 0st),1.409
947,47,MS Wade (AUS),2012-2017,94,94,117,108,9,108,0,5 (5ct 0st),1.244
948,48,Inzamam-ul-Haq (Asia/PAK),1991-2007,378,373,113,113,0,0,113,3 (3ct 0st),0.302
949,49,SR Waugh (AUS),1986-2002,325,324,111,111,0,0,111,3 (3ct 0st),0.342
950,0,KC Sangakkara (Asia/ICC/SL),2000-2015,404,397,501,402,99,383,19,5 (4ct 1st),1.261
951,1,AC Gilchrist (AUS/ICC),1996-2008,287,286,472,417,55,417,0,6 (6ct 0st),1.65
952,2,MS Dhoni (Asia/INDIA),2004-2019,350,345,444,321,123,321,0,6 (5ct 1st),1.286
953,3,MV Boucher (Afr/SA),1998-2011,295,291,425,403,22,402,1,6 (6ct 0st),1.46
954,4,Moin Khan (PAK),1990-2004,219,217,287,214,73,214,0,5 (5ct 0st),1.3219999999999998
955,5,BB McCullum (NZ),2002-2016,260,257,277,262,15,227,35,5 (5ct 0st),1.077
956,6,IA Healy (AUS),1988-1997,168,168,233,194,39,194,0,4 (4ct 0st),1.386
957,7,Mushfiqur Rahim (BDESH),2006-2019,216,215,225,181,44,179,2,5 (5ct 0st),1.046
958,8,Rashid Latif (PAK),1992-2003,166,164,220,182,38,182,0,5 (5ct 0st),1.341
959,9,DPMD Jayawardene (Asia/SL),1998-2015,448,443,218,218,0,0,218,4 (4ct 0st),0.492
960,10,R Dravid (Asia/ICC/INDIA),1996-2011,344,341,210,196,14,72,124,4 (4ct 0st),0.615
961,11,RS Kaluwitharana (SL),1990-2004,189,188,207,132,75,131,1,5 (4ct 1st),1.101
962,12,PJL Dujon (WI),1981-1991,169,168,204,183,21,183,0,4 (4ct 0st),1.214
963,13,JC Buttler (ENG),2012-2019,142,138,202,171,31,171,0,6 (6ct 0st),1.463
964,14,RD Jacobs (WI),1996-2004,147,145,189,160,29,160,0,6 (5ct 1st),1.3030000000000002
965,15,Kamran Akmal (PAK),2002-2017,157,154,188,157,31,156,1,5 (4ct 1st),1.22
966,16,D Ramdin (WI),2005-2016,139,137,188,181,7,181,0,5 (5ct 0st),1.372
967,17,AB de Villiers (Afr/SA),2005-2018,228,223,181,176,5,93,83,5 (5ct 0st),0.8109999999999999
968,18,BJ Haddin (AUS),2001-2015,126,124,181,170,11,170,0,5 (5ct 0st),1.459
969,19,AJ Stewart (ENG),1989-2003,170,169,174,159,15,148,11,6 (6ct 0st),1.029
970,20,A Flower (ZIM),1992-2003,213,212,173,141,32,133,8,5 (5ct 0st),0.816
971,21,Q de Kock (SA),2013-2019,115,111,166,158,8,158,0,6 (5ct 1st),1.495
972,22,DJ Richardson (SA),1991-1998,122,121,165,148,17,148,0,5 (5ct 0st),1.3630000000000002
973,23,RT Ponting (AUS/ICC),1995-2012,375,372,160,160,0,0,160,3 (3ct 0st),0.43
974,24,M Azharuddin (INDIA),1985-2000,334,332,156,156,0,0,156,4 (4ct 0st),0.469
975,25,NR Mongia (INDIA),1994-2000,140,139,154,110,44,110,0,5 (4ct 1st),1.107
976,26,BRM Taylor (ZIM),2004-2019,193,193,154,125,29,96,29,5 (5ct 0st),0.797
977,27,T Taibu (Afr/ZIM),2001-2012,150,150,147,114,33,112,2,4 (4ct 0st),0.98
978,28,AC Parore (NZ),1992-2002,179,178,141,116,25,111,5,5 (3ct 2st),0.792
979,29,Sarfaraz Ahmed (PAK),2007-2019,116,114,140,116,24,116,0,6 (6ct 0st),1.228
980,30,SR Tendulkar (INDIA),1989-2012,463,456,140,140,0,0,140,4 (4ct 0st),0.307
981,31,LRPL Taylor (NZ),2006-2019,228,224,137,137,0,0,137,4 (4ct 0st),0.611
982,32,Younis Khan (PAK),2000-2015,265,260,135,135,0,5,130,4 (4ct 0st),0.519
983,33,SP Fleming (ICC/NZ),1994-2007,280,276,133,133,0,0,133,4 (4ct 0st),0.481
984,34,JH Kallis (Afr/ICC/SA),1996-2014,328,324,131,131,0,0,131,3 (3ct 0st),0.4039999999999999
985,35,M Muralitharan (Asia/ICC/SL),1993-2011,350,347,130,130,0,0,130,3 (3ct 0st),0.374
986,36,AR Border (AUS),1979-1994,273,270,127,127,0,0,127,3 (3ct 0st),0.47
987,37,Shahid Afridi (Asia/ICC/PAK),1996-2015,398,392,127,127,0,0,127,2 (2ct 0st),0.3229999999999999
988,38,Khaled Mashud (BDESH),1995-2006,126,126,126,91,35,91,0,5 (3ct 2st),1.0
989,39,TM Dilshan (SL),1999-2016,330,325,124,123,1,5,118,3 (3ct 0st),0.381
990,40,CH Gayle (ICC/WI),1999-2019,301,294,124,124,0,0,124,3 (3ct 0st),0.421
991,41,V Kohli (INDIA),2008-2019,242,240,124,124,0,0,124,3 (3ct 0st),0.516
992,42,RW Marsh (AUS),1971-1984,92,92,124,120,4,120,0,5 (5ct 0st),1.347
993,43,ST Jayasuriya (Asia/SL),1989-2011,445,441,123,123,0,0,123,3 (3ct 0st),0.278
994,44,CL Hooper (WI),1987-2003,227,225,120,120,0,0,120,4 (4ct 0st),0.5329999999999999
995,45,BC Lara (ICC/WI),1990-2007,299,296,120,120,0,0,120,3 (3ct 0st),0.405
996,46,L Ronchi (AUS/NZ),2008-2017,85,83,117,105,12,105,0,4 (4ct 0st),1.409
997,47,MS Wade (AUS),2012-2017,94,94,117,108,9,108,0,5 (5ct 0st),1.244
998,48,Inzamam-ul-Haq (Asia/PAK),1991-2007,378,373,113,113,0,0,113,3 (3ct 0st),0.302
999,49,SR Waugh (AUS),1986-2002,325,324,111,111,0,0,111,3 (3ct 0st),0.342
1000,0,KC Sangakkara (Asia/ICC/SL),2000-2015,404,397,501,402,99,383,19,5 (4ct 1st),1.261
1001,1,AC Gilchrist (AUS/ICC),1996-2008,287,286,472,417,55,417,0,6 (6ct 0st),1.65
1002,2,MS Dhoni (Asia/INDIA),2004-2019,350,345,444,321,123,321,0,6 (5ct 1st),1.286
1003,3,MV Boucher (Afr/SA),1998-2011,295,291,425,403,22,402,1,6 (6ct 0st),1.46
1004,4,Moin Khan (PAK),1990-2004,219,217,287,214,73,214,0,5 (5ct 0st),1.3219999999999998
1005,5,BB McCullum (NZ),2002-2016,260,257,277,262,15,227,35,5 (5ct 0st),1.077
1006,6,IA Healy (AUS),1988-1997,168,168,233,194,39,194,0,4 (4ct 0st),1.386
1007,7,Mushfiqur Rahim (BDESH),2006-2019,216,215,225,181,44,179,2,5 (5ct 0st),1.046
1008,8,Rashid Latif (PAK),1992-2003,166,164,220,182,38,182,0,5 (5ct 0st),1.341
1009,9,DPMD Jayawardene (Asia/SL),1998-2015,448,443,218,218,0,0,218,4 (4ct 0st),0.492
1010,10,R Dravid (Asia/ICC/INDIA),1996-2011,344,341,210,196,14,72,124,4 (4ct 0st),0.615
1011,11,RS Kaluwitharana (SL),1990-2004,189,188,207,132,75,131,1,5 (4ct 1st),1.101
1012,12,PJL Dujon (WI),1981-1991,169,168,204,183,21,183,0,4 (4ct 0st),1.214
1013,13,JC Buttler (ENG),2012-2019,142,138,202,171,31,171,0,6 (6ct 0st),1.463
1014,14,RD Jacobs (WI),1996-2004,147,145,189,160,29,160,0,6 (5ct 1st),1.3030000000000002
1015,15,Kamran Akmal (PAK),2002-2017,157,154,188,157,31,156,1,5 (4ct 1st),1.22
1016,16,D Ramdin (WI),2005-2016,139,137,188,181,7,181,0,5 (5ct 0st),1.372
1017,17,AB de Villiers (Afr/SA),2005-2018,228,223,181,176,5,93,83,5 (5ct 0st),0.8109999999999999
1018,18,BJ Haddin (AUS),2001-2015,126,124,181,170,11,170,0,5 (5ct 0st),1.459
1019,19,AJ Stewart (ENG),1989-2003,170,169,174,159,15,148,11,6 (6ct 0st),1.029
1020,20,A Flower (ZIM),1992-2003,213,212,173,141,32,133,8,5 (5ct 0st),0.816
1021,21,Q de Kock (SA),2013-2019,115,111,166,158,8,158,0,6 (5ct 1st),1.495
1022,22,DJ Richardson (SA),1991-1998,122,121,165,148,17,148,0,5 (5ct 0st),1.3630000000000002
1023,23,RT Ponting (AUS/ICC),1995-2012,375,372,160,160,0,0,160,3 (3ct 0st),0.43
1024,24,M Azharuddin (INDIA),1985-2000,334,332,156,156,0,0,156,4 (4ct 0st),0.469
1025,25,NR Mongia (INDIA),1994-2000,140,139,154,110,44,110,0,5 (4ct 1st),1.107
1026,26,BRM Taylor (ZIM),2004-2019,193,193,154,125,29,96,29,5 (5ct 0st),0.797
1027,27,T Taibu (Afr/ZIM),2001-2012,150,150,147,114,33,112,2,4 (4ct 0st),0.98
1028,28,AC Parore (NZ),1992-2002,179,178,141,116,25,111,5,5 (3ct 2st),0.792
1029,29,Sarfaraz Ahmed (PAK),2007-2019,116,114,140,116,24,116,0,6 (6ct 0st),1.228
1030,30,SR Tendulkar (INDIA),1989-2012,463,456,140,140,0,0,140,4 (4ct 0st),0.307
1031,31,LRPL Taylor (NZ),2006-2019,228,224,137,137,0,0,137,4 (4ct 0st),0.611
1032,32,Younis Khan (PAK),2000-2015,265,260,135,135,0,5,130,4 (4ct 0st),0.519
1033,33,SP Fleming (ICC/NZ),1994-2007,280,276,133,133,0,0,133,4 (4ct 0st),0.481
1034,34,JH Kallis (Afr/ICC/SA),1996-2014,328,324,131,131,0,0,131,3 (3ct 0st),0.4039999999999999
1035,35,M Muralitharan (Asia/ICC/SL),1993-2011,350,347,130,130,0,0,130,3 (3ct 0st),0.374
1036,36,AR Border (AUS),1979-1994,273,270,127,127,0,0,127,3 (3ct 0st),0.47
1037,37,Shahid Afridi (Asia/ICC/PAK),1996-2015,398,392,127,127,0,0,127,2 (2ct 0st),0.3229999999999999
1038,38,Khaled Mashud (BDESH),1995-2006,126,126,126,91,35,91,0,5 (3ct 2st),1.0
1039,39,TM Dilshan (SL),1999-2016,330,325,124,123,1,5,118,3 (3ct 0st),0.381
1040,40,CH Gayle (ICC/WI),1999-2019,301,294,124,124,0,0,124,3 (3ct 0st),0.421
1041,41,V Kohli (INDIA),2008-2019,242,240,124,124,0,0,124,3 (3ct 0st),0.516
1042,42,RW Marsh (AUS),1971-1984,92,92,124,120,4,120,0,5 (5ct 0st),1.347
1043,43,ST Jayasuriya (Asia/SL),1989-2011,445,441,123,123,0,0,123,3 (3ct 0st),0.278
1044,44,CL Hooper (WI),1987-2003,227,225,120,120,0,0,120,4 (4ct 0st),0.5329999999999999
1045,45,BC Lara (ICC/WI),1990-2007,299,296,120,120,0,0,120,3 (3ct 0st),0.405
1046,46,L Ronchi (AUS/NZ),2008-2017,85,83,117,105,12,105,0,4 (4ct 0st),1.409
1047,47,MS Wade (AUS),2012-2017,94,94,117,108,9,108,0,5 (5ct 0st),1.244
1048,48,Inzamam-ul-Haq (Asia/PAK),1991-2007,378,373,113,113,0,0,113,3 (3ct 0st),0.302
1049,49,SR Waugh (AUS),1986-2002,325,324,111,111,0,0,111,3 (3ct 0st),0.342
1050,0,KC Sangakkara (Asia/ICC/SL),2000-2015,404,397,501,402,99,383,19,5 (4ct 1st),1.261
1051,1,AC Gilchrist (AUS/ICC),1996-2008,287,286,472,417,55,417,0,6 (6ct 0st),1.65
1052,2,MS Dhoni (Asia/INDIA),2004-2019,350,345,444,321,123,321,0,6 (5ct 1st),1.286
1053,3,MV Boucher (Afr/SA),1998-2011,295,291,425,403,22,402,1,6 (6ct 0st),1.46
1054,4,Moin Khan (PAK),1990-2004,219,217,287,214,73,214,0,5 (5ct 0st),1.3219999999999998
1055,5,BB McCullum (NZ),2002-2016,260,257,277,262,15,227,35,5 (5ct 0st),1.077
1056,6,IA Healy (AUS),1988-1997,168,168,233,194,39,194,0,4 (4ct 0st),1.386
1057,7,Mushfiqur Rahim (BDESH),2006-2019,216,215,225,181,44,179,2,5 (5ct 0st),1.046
1058,8,Rashid Latif (PAK),1992-2003,166,164,220,182,38,182,0,5 (5ct 0st),1.341
1059,9,DPMD Jayawardene (Asia/SL),1998-2015,448,443,218,218,0,0,218,4 (4ct 0st),0.492
1060,10,R Dravid (Asia/ICC/INDIA),1996-2011,344,341,210,196,14,72,124,4 (4ct 0st),0.615
1061,11,RS Kaluwitharana (SL),1990-2004,189,188,207,132,75,131,1,5 (4ct 1st),1.101
1062,12,PJL Dujon (WI),1981-1991,169,168,204,183,21,183,0,4 (4ct 0st),1.214
1063,13,JC Buttler (ENG),2012-2019,142,138,202,171,31,171,0,6 (6ct 0st),1.463
1064,14,RD Jacobs (WI),1996-2004,147,145,189,160,29,160,0,6 (5ct 1st),1.3030000000000002
1065,15,Kamran Akmal (PAK),2002-2017,157,154,188,157,31,156,1,5 (4ct 1st),1.22
1066,16,D Ramdin (WI),2005-2016,139,137,188,181,7,181,0,5 (5ct 0st),1.372
1067,17,AB de Villiers (Afr/SA),2005-2018,228,223,181,176,5,93,83,5 (5ct 0st),0.8109999999999999
1068,18,BJ Haddin (AUS),2001-2015,126,124,181,170,11,170,0,5 (5ct 0st),1.459
1069,19,AJ Stewart (ENG),1989-2003,170,169,174,159,15,148,11,6 (6ct 0st),1.029
1070,20,A Flower (ZIM),1992-2003,213,212,173,141,32,133,8,5 (5ct 0st),0.816
1071,21,Q de Kock (SA),2013-2019,115,111,166,158,8,158,0,6 (5ct 1st),1.495
1072,22,DJ Richardson (SA),1991-1998,122,121,165,148,17,148,0,5 (5ct 0st),1.3630000000000002
1073,23,RT Ponting (AUS/ICC),1995-2012,375,372,160,160,0,0,160,3 (3ct 0st),0.43
1074,24,M Azharuddin (INDIA),1985-2000,334,332,156,156,0,0,156,4 (4ct 0st),0.469
1075,25,NR Mongia (INDIA),1994-2000,140,139,154,110,44,110,0,5 (4ct 1st),1.107
1076,26,BRM Taylor (ZIM),2004-2019,193,193,154,125,29,96,29,5 (5ct 0st),0.797
1077,27,T Taibu (Afr/ZIM),2001-2012,150,150,147,114,33,112,2,4 (4ct 0st),0.98
1078,28,AC Parore (NZ),1992-2002,179,178,141,116,25,111,5,5 (3ct 2st),0.792
1079,29,Sarfaraz Ahmed (PAK),2007-2019,116,114,140,116,24,116,0,6 (6ct 0st),1.228
1080,30,SR Tendulkar (INDIA),1989-2012,463,456,140,140,0,0,140,4 (4ct 0st),0.307
1081,31,LRPL Taylor (NZ),2006-2019,228,224,137,137,0,0,137,4 (4ct 0st),0.611
1082,32,Younis Khan (PAK),2000-2015,265,260,135,135,0,5,130,4 (4ct 0st),0.519
1083,33,SP Fleming (ICC/NZ),1994-2007,280,276,133,133,0,0,133,4 (4ct 0st),0.481
1084,34,JH Kallis (Afr/ICC/SA),1996-2014,328,324,131,131,0,0,131,3 (3ct 0st),0.4039999999999999
1085,35,M Muralitharan (Asia/ICC/SL),1993-2011,350,347,130,130,0,0,130,3 (3ct 0st),0.374
1086,36,AR Border (AUS),1979-1994,273,270,127,127,0,0,127,3 (3ct 0st),0.47
1087,37,Shahid Afridi (Asia/ICC/PAK),1996-2015,398,392,127,127,0,0,127,2 (2ct 0st),0.3229999999999999
1088,38,Khaled Mashud (BDESH),1995-2006,126,126,126,91,35,91,0,5 (3ct 2st),1.0
1089,39,TM Dilshan (SL),1999-2016,330,325,124,123,1,5,118,3 (3ct 0st),0.381
1090,40,CH Gayle (ICC/WI),1999-2019,301,294,124,124,0,0,124,3 (3ct 0st),0.421
1091,41,V Kohli (INDIA),2008-2019,242,240,124,124,0,0,124,3 (3ct 0st),0.516
1092,42,RW Marsh (AUS),1971-1984,92,92,124,120,4,120,0,5 (5ct 0st),1.347
1093,43,ST Jayasuriya (Asia/SL),1989-2011,445,441,123,123,0,0,123,3 (3ct 0st),0.278
1094,44,CL Hooper (WI),1987-2003,227,225,120,120,0,0,120,4 (4ct 0st),0.5329999999999999
1095,45,BC Lara (ICC/WI),1990-2007,299,296,120,120,0,0,120,3 (3ct 0st),0.405
1096,46,L Ronchi (AUS/NZ),2008-2017,85,83,117,105,12,105,0,4 (4ct 0st),1.409
1097,47,MS Wade (AUS),2012-2017,94,94,117,108,9,108,0,5 (5ct 0st),1.244
1098,48,Inzamam-ul-Haq (Asia/PAK),1991-2007,378,373,113,113,0,0,113,3 (3ct 0st),0.302
1099,49,SR Waugh (AUS),1986-2002,325,324,111,111,0,0,111,3 (3ct 0st),0.342
1100,0,KC Sangakkara (Asia/ICC/SL),2000-2015,404,397,501,402,99,383,19,5 (4ct 1st),1.261
1101,1,AC Gilchrist (AUS/ICC),1996-2008,287,286,472,417,55,417,0,6 (6ct 0st),1.65
1102,2,MS Dhoni (Asia/INDIA),2004-2019,350,345,444,321,123,321,0,6 (5ct 1st),1.286
1103,3,MV Boucher (Afr/SA),1998-2011,295,291,425,403,22,402,1,6 (6ct 0st),1.46
1104,4,Moin Khan (PAK),1990-2004,219,217,287,214,73,214,0,5 (5ct 0st),1.3219999999999998
1105,5,BB McCullum (NZ),2002-2016,260,257,277,262,15,227,35,5 (5ct 0st),1.077
1106,6,IA Healy (AUS),1988-1997,168,168,233,194,39,194,0,4 (4ct 0st),1.386
1107,7,Mushfiqur Rahim (BDESH),2006-2019,216,215,225,181,44,179,2,5 (5ct 0st),1.046
1108,8,Rashid Latif (PAK),1992-2003,166,164,220,182,38,182,0,5 (5ct 0st),1.341
1109,9,DPMD Jayawardene (Asia/SL),1998-2015,448,443,218,218,0,0,218,4 (4ct 0st),0.492
1110,10,R Dravid (Asia/ICC/INDIA),1996-2011,344,341,210,196,14,72,124,4 (4ct 0st),0.615
1111,11,RS Kaluwitharana (SL),1990-2004,189,188,207,132,75,131,1,5 (4ct 1st),1.101
1112,12,PJL Dujon (WI),1981-1991,169,168,204,183,21,183,0,4 (4ct 0st),1.214
1113,13,JC Buttler (ENG),2012-2019,142,138,202,171,31,171,0,6 (6ct 0st),1.463
1114,14,RD Jacobs (WI),1996-2004,147,145,189,160,29,160,0,6 (5ct 1st),1.3030000000000002
1115,15,Kamran Akmal (PAK),2002-2017,157,154,188,157,31,156,1,5 (4ct 1st),1.22
1116,16,D Ramdin (WI),2005-2016,139,137,188,181,7,181,0,5 (5ct 0st),1.372
1117,17,AB de Villiers (Afr/SA),2005-2018,228,223,181,176,5,93,83,5 (5ct 0st),0.8109999999999999
1118,18,BJ Haddin (AUS),2001-2015,126,124,181,170,11,170,0,5 (5ct 0st),1.459
1119,19,AJ Stewart (ENG),1989-2003,170,169,174,159,15,148,11,6 (6ct 0st),1.029
1120,20,A Flower (ZIM),1992-2003,213,212,173,141,32,133,8,5 (5ct 0st),0.816
1121,21,Q de Kock (SA),2013-2019,115,111,166,158,8,158,0,6 (5ct 1st),1.495
1122,22,DJ Richardson (SA),1991-1998,122,121,165,148,17,148,0,5 (5ct 0st),1.3630000000000002
1123,23,RT Ponting (AUS/ICC),1995-2012,375,372,160,160,0,0,160,3 (3ct 0st),0.43
1124,24,M Azharuddin (INDIA),1985-2000,334,332,156,156,0,0,156,4 (4ct 0st),0.469
1125,25,NR Mongia (INDIA),1994-2000,140,139,154,110,44,110,0,5 (4ct 1st),1.107
1126,26,BRM Taylor (ZIM),2004-2019,193,193,154,125,29,96,29,5 (5ct 0st),0.797
1127,27,T Taibu (Afr/ZIM),2001-2012,150,150,147,114,33,112,2,4 (4ct 0st),0.98
1128,28,AC Parore (NZ),1992-2002,179,178,141,116,25,111,5,5 (3ct 2st),0.792
1129,29,Sarfaraz Ahmed (PAK),2007-2019,116,114,140,116,24,116,0,6 (6ct 0st),1.228
1130,30,SR Tendulkar (INDIA),1989-2012,463,456,140,140,0,0,140,4 (4ct 0st),0.307
1131,31,LRPL Taylor (NZ),2006-2019,228,224,137,137,0,0,137,4 (4ct 0st),0.611
1132,32,Younis Khan (PAK),2000-2015,265,260,135,135,0,5,130,4 (4ct 0st),0.519
1133,33,SP Fleming (ICC/NZ),1994-2007,280,276,133,133,0,0,133,4 (4ct 0st),0.481
1134,34,JH Kallis (Afr/ICC/SA),1996-2014,328,324,131,131,0,0,131,3 (3ct 0st),0.4039999999999999
1135,35,M Muralitharan (Asia/ICC/SL),1993-2011,350,347,130,130,0,0,130,3 (3ct 0st),0.374
1136,36,AR Border (AUS),1979-1994,273,270,127,127,0,0,127,3 (3ct 0st),0.47
1137,37,Shahid Afridi (Asia/ICC/PAK),1996-2015,398,392,127,127,0,0,127,2 (2ct 0st),0.3229999999999999
1138,38,Khaled Mashud (BDESH),1995-2006,126,126,126,91,35,91,0,5 (3ct 2st),1.0
1139,39,TM Dilshan (SL),1999-2016,330,325,124,123,1,5,118,3 (3ct 0st),0.381
1140,40,CH Gayle (ICC/WI),1999-2019,301,294,124,124,0,0,124,3 (3ct 0st),0.421
1141,41,V Kohli (INDIA),2008-2019,242,240,124,124,0,0,124,3 (3ct 0st),0.516
1142,42,RW Marsh (AUS),1971-1984,92,92,124,120,4,120,0,5 (5ct 0st),1.347
1143,43,ST Jayasuriya (Asia/SL),1989-2011,445,441,123,123,0,0,123,3 (3ct 0st),0.278
1144,44,CL Hooper (WI),1987-2003,227,225,120,120,0,0,120,4 (4ct 0st),0.5329999999999999
1145,45,BC Lara (ICC/WI),1990-2007,299,296,120,120,0,0,120,3 (3ct 0st),0.405
1146,46,L Ronchi (AUS/NZ),2008-2017,85,83,117,105,12,105,0,4 (4ct 0st),1.409
1147,47,MS Wade (AUS),2012-2017,94,94,117,108,9,108,0,5 (5ct 0st),1.244
1148,48,Inzamam-ul-Haq (Asia/PAK),1991-2007,378,373,113,113,0,0,113,3 (3ct 0st),0.302
1149,49,SR Waugh (AUS),1986-2002,325,324,111,111,0,0,111,3 (3ct 0st),0.342
1150,0,KC Sangakkara (Asia/ICC/SL),2000-2015,404,397,501,402,99,383,19,5 (4ct 1st),1.261
1151,1,AC Gilchrist (AUS/ICC),1996-2008,287,286,472,417,55,417,0,6 (6ct 0st),1.65
1152,2,MS Dhoni (Asia/INDIA),2004-2019,350,345,444,321,123,321,0,6 (5ct 1st),1.286
1153,3,MV Boucher (Afr/SA),1998-2011,295,291,425,403,22,402,1,6 (6ct 0st),1.46
1154,4,Moin Khan (PAK),1990-2004,219,217,287,214,73,214,0,5 (5ct 0st),1.3219999999999998
1155,5,BB McCullum (NZ),2002-2016,260,257,277,262,15,227,35,5 (5ct 0st),1.077
1156,6,IA Healy (AUS),1988-1997,168,168,233,194,39,194,0,4 (4ct 0st),1.386
1157,7,Mushfiqur Rahim (BDESH),2006-2019,216,215,225,181,44,179,2,5 (5ct 0st),1.046
1158,8,Rashid Latif (PAK),1992-2003,166,164,220,182,38,182,0,5 (5ct 0st),1.341
1159,9,DPMD Jayawardene (Asia/SL),1998-2015,448,443,218,218,0,0,218,4 (4ct 0st),0.492
1160,10,R Dravid (Asia/ICC/INDIA),1996-2011,344,341,210,196,14,72,124,4 (4ct 0st),0.615
1161,11,RS Kaluwitharana (SL),1990-2004,189,188,207,132,75,131,1,5 (4ct 1st),1.101
1162,12,PJL Dujon (WI),1981-1991,169,168,204,183,21,183,0,4 (4ct 0st),1.214
1163,13,JC Buttler (ENG),2012-2019,142,138,202,171,31,171,0,6 (6ct 0st),1.463
1164,14,RD Jacobs (WI),1996-2004,147,145,189,160,29,160,0,6 (5ct 1st),1.3030000000000002
1165,15,Kamran Akmal (PAK),2002-2017,157,154,188,157,31,156,1,5 (4ct 1st),1.22
1166,16,D Ramdin (WI),2005-2016,139,137,188,181,7,181,0,5 (5ct 0st),1.372
1167,17,AB de Villiers (Afr/SA),2005-2018,228,223,181,176,5,93,83,5 (5ct 0st),0.8109999999999999
1168,18,BJ Haddin (AUS),2001-2015,126,124,181,170,11,170,0,5 (5ct 0st),1.459
1169,19,AJ Stewart (ENG),1989-2003,170,169,174,159,15,148,11,6 (6ct 0st),1.029
1170,20,A Flower (ZIM),1992-2003,213,212,173,141,32,133,8,5 (5ct 0st),0.816
1171,21,Q de Kock (SA),2013-2019,115,111,166,158,8,158,0,6 (5ct 1st),1.495
1172,22,DJ Richardson (SA),1991-1998,122,121,165,148,17,148,0,5 (5ct 0st),1.3630000000000002
1173,23,RT Ponting (AUS/ICC),1995-2012,375,372,160,160,0,0,160,3 (3ct 0st),0.43
1174,24,M Azharuddin (INDIA),1985-2000,334,332,156,156,0,0,156,4 (4ct 0st),0.469
1175,25,NR Mongia (INDIA),1994-2000,140,139,154,110,44,110,0,5 (4ct 1st),1.107
1176,26,BRM Taylor (ZIM),2004-2019,193,193,154,125,29,96,29,5 (5ct 0st),0.797
1177,27,T Taibu (Afr/ZIM),2001-2012,150,150,147,114,33,112,2,4 (4ct 0st),0.98
1178,28,AC Parore (NZ),1992-2002,179,178,141,116,25,111,5,5 (3ct 2st),0.792
1179,29,Sarfaraz Ahmed (PAK),2007-2019,116,114,140,116,24,116,0,6 (6ct 0st),1.228
1180,30,SR Tendulkar (INDIA),1989-2012,463,456,140,140,0,0,140,4 (4ct 0st),0.307
1181,31,LRPL Taylor (NZ),2006-2019,228,224,137,137,0,0,137,4 (4ct 0st),0.611
1182,32,Younis Khan (PAK),2000-2015,265,260,135,135,0,5,130,4 (4ct 0st),0.519
1183,33,SP Fleming (ICC/NZ),1994-2007,280,276,133,133,0,0,133,4 (4ct 0st),0.481
1184,34,JH Kallis (Afr/ICC/SA),1996-2014,328,324,131,131,0,0,131,3 (3ct 0st),0.4039999999999999
1185,35,M Muralitharan (Asia/ICC/SL),1993-2011,350,347,130,130,0,0,130,3 (3ct 0st),0.374
1186,36,AR Border (AUS),1979-1994,273,270,127,127,0,0,127,3 (3ct 0st),0.47
1187,37,Shahid Afridi (Asia/ICC/PAK),1996-2015,398,392,127,127,0,0,127,2 (2ct 0st),0.3229999999999999
1188,38,Khaled Mashud (BDESH),1995-2006,126,126,126,91,35,91,0,5 (3ct 2st),1.0
1189,39,TM Dilshan (SL),1999-2016,330,325,124,123,1,5,118,3 (3ct 0st),0.381
1190,40,CH Gayle (ICC/WI),1999-2019,301,294,124,124,0,0,124,3 (3ct 0st),0.421
1191,41,V Kohli (INDIA),2008-2019,242,240,124,124,0,0,124,3 (3ct 0st),0.516
1192,42,RW Marsh (AUS),1971-1984,92,92,124,120,4,120,0,5 (5ct 0st),1.347
1193,43,ST Jayasuriya (Asia/SL),1989-2011,445,441,123,123,0,0,123,3 (3ct 0st),0.278
1194,44,CL Hooper (WI),1987-2003,227,225,120,120,0,0,120,4 (4ct 0st),0.5329999999999999
1195,45,BC Lara (ICC/WI),1990-2007,299,296,120,120,0,0,120,3 (3ct 0st),0.405
1196,46,L Ronchi (AUS/NZ),2008-2017,85,83,117,105,12,105,0,4 (4ct 0st),1.409
1197,47,MS Wade (AUS),2012-2017,94,94,117,108,9,108,0,5 (5ct 0st),1.244
1198,48,Inzamam-ul-Haq (Asia/PAK),1991-2007,378,373,113,113,0,0,113,3 (3ct 0st),0.302
1199,49,SR Waugh (AUS),1986-2002,325,324,111,111,0,0,111,3 (3ct 0st),0.342
1200,0,KC Sangakkara (Asia/ICC/SL),2000-2015,404,397,501,402,99,383,19,5 (4ct 1st),1.261
1201,1,AC Gilchrist (AUS/ICC),1996-2008,287,286,472,417,55,417,0,6 (6ct 0st),1.65
1202,2,MS Dhoni (Asia/INDIA),2004-2019,350,345,444,321,123,321,0,6 (5ct 1st),1.286
1203,3,MV Boucher (Afr/SA),1998-2011,295,291,425,403,22,402,1,6 (6ct 0st),1.46
1204,4,Moin Khan (PAK),1990-2004,219,217,287,214,73,214,0,5 (5ct 0st),1.3219999999999998
1205,5,BB McCullum (NZ),2002-2016,260,257,277,262,15,227,35,5 (5ct 0st),1.077
1206,6,IA Healy (AUS),1988-1997,168,168,233,194,39,194,0,4 (4ct 0st),1.386
1207,7,Mushfiqur Rahim (BDESH),2006-2019,216,215,225,181,44,179,2,5 (5ct 0st),1.046
1208,8,Rashid Latif (PAK),1992-2003,166,164,220,182,38,182,0,5 (5ct 0st),1.341
1209,9,DPMD Jayawardene (Asia/SL),1998-2015,448,443,218,218,0,0,218,4 (4ct 0st),0.492
1210,10,R Dravid (Asia/ICC/INDIA),1996-2011,344,341,210,196,14,72,124,4 (4ct 0st),0.615
1211,11,RS Kaluwitharana (SL),1990-2004,189,188,207,132,75,131,1,5 (4ct 1st),1.101
1212,12,PJL Dujon (WI),1981-1991,169,168,204,183,21,183,0,4 (4ct 0st),1.214
1213,13,JC Buttler (ENG),2012-2019,142,138,202,171,31,171,0,6 (6ct 0st),1.463
1214,14,RD Jacobs (WI),1996-2004,147,145,189,160,29,160,0,6 (5ct 1st),1.3030000000000002
1215,15,Kamran Akmal (PAK),2002-2017,157,154,188,157,31,156,1,5 (4ct 1st),1.22
1216,16,D Ramdin (WI),2005-2016,139,137,188,181,7,181,0,5 (5ct 0st),1.372
1217,17,AB de Villiers (Afr/SA),2005-2018,228,223,181,176,5,93,83,5 (5ct 0st),0.8109999999999999
1218,18,BJ Haddin (AUS),2001-2015,126,124,181,170,11,170,0,5 (5ct 0st),1.459
1219,19,AJ Stewart (ENG),1989-2003,170,169,174,159,15,148,11,6 (6ct 0st),1.029
1220,20,A Flower (ZIM),1992-2003,213,212,173,141,32,133,8,5 (5ct 0st),0.816
1221,21,Q de Kock (SA),2013-2019,115,111,166,158,8,158,0,6 (5ct 1st),1.495
1222,22,DJ Richardson (SA),1991-1998,122,121,165,148,17,148,0,5 (5ct 0st),1.3630000000000002
1223,23,RT Ponting (AUS/ICC),1995-2012,375,372,160,160,0,0,160,3 (3ct 0st),0.43
1224,24,M Azharuddin (INDIA),1985-2000,334,332,156,156,0,0,156,4 (4ct 0st),0.469
1225,25,NR Mongia (INDIA),1994-2000,140,139,154,110,44,110,0,5 (4ct 1st),1.107
1226,26,BRM Taylor (ZIM),2004-2019,193,193,154,125,29,96,29,5 (5ct 0st),0.797
1227,27,T Taibu (Afr/ZIM),2001-2012,150,150,147,114,33,112,2,4 (4ct 0st),0.98
1228,28,AC Parore (NZ),1992-2002,179,178,141,116,25,111,5,5 (3ct 2st),0.792
1229,29,Sarfaraz Ahmed (PAK),2007-2019,116,114,140,116,24,116,0,6 (6ct 0st),1.228
1230,30,SR Tendulkar (INDIA),1989-2012,463,456,140,140,0,0,140,4 (4ct 0st),0.307
1231,31,LRPL Taylor (NZ),2006-2019,228,224,137,137,0,0,137,4 (4ct 0st),0.611
1232,32,Younis Khan (PAK),2000-2015,265,260,135,135,0,5,130,4 (4ct 0st),0.519
1233,33,SP Fleming (ICC/NZ),1994-2007,280,276,133,133,0,0,133,4 (4ct 0st),0.481
1234,34,JH Kallis (Afr/ICC/SA),1996-2014,328,324,131,131,0,0,131,3 (3ct 0st),0.4039999999999999
1235,35,M Muralitharan (Asia/ICC/SL),1993-2011,350,347,130,130,0,0,130,3 (3ct 0st),0.374
1236,36,AR Border (AUS),1979-1994,273,270,127,127,0,0,127,3 (3ct 0st),0.47
1237,37,Shahid Afridi (Asia/ICC/PAK),1996-2015,398,392,127,127,0,0,127,2 (2ct 0st),0.3229999999999999
1238,38,Khaled Mashud (BDESH),1995-2006,126,126,126,91,35,91,0,5 (3ct 2st),1.0
1239,39,TM Dilshan (SL),1999-2016,330,325,124,123,1,5,118,3 (3ct 0st),0.381
1240,40,CH Gayle (ICC/WI),1999-2019,301,294,124,124,0,0,124,3 (3ct 0st),0.421
1241,41,V Kohli (INDIA),2008-2019,242,240,124,124,0,0,124,3 (3ct 0st),0.516
1242,42,RW Marsh (AUS),1971-1984,92,92,124,120,4,120,0,5 (5ct 0st),1.347
1243,43,ST Jayasuriya (Asia/SL),1989-2011,445,441,123,123,0,0,123,3 (3ct 0st),0.278
1244,44,CL Hooper (WI),1987-2003,227,225,120,120,0,0,120,4 (4ct 0st),0.5329999999999999
1245,45,BC Lara (ICC/WI),1990-2007,299,296,120,120,0,0,120,3 (3ct 0st),0.405
1246,46,L Ronchi (AUS/NZ),2008-2017,85,83,117,105,12,105,0,4 (4ct 0st),1.409
1247,47,MS Wade (AUS),2012-2017,94,94,117,108,9,108,0,5 (5ct 0st),1.244
1248,48,Inzamam-ul-Haq (Asia/PAK),1991-2007,378,373,113,113,0,0,113,3 (3ct 0st),0.302
1249,49,SR Waugh (AUS),1986-2002,325,324,111,111,0,0,111,3 (3ct 0st),0.342
1250,0,KC Sangakkara (Asia/ICC/SL),2000-2015,404,397,501,402,99,383,19,5 (4ct 1st),1.261
1251,1,AC Gilchrist (AUS/ICC),1996-2008,287,286,472,417,55,417,0,6 (6ct 0st),1.65
1252,2,MS Dhoni (Asia/INDIA),2004-2019,350,345,444,321,123,321,0,6 (5ct 1st),1.286
1253,3,MV Boucher (Afr/SA),1998-2011,295,291,425,403,22,402,1,6 (6ct 0st),1.46
1254,4,Moin Khan (PAK),1990-2004,219,217,287,214,73,214,0,5 (5ct 0st),1.3219999999999998
1255,5,BB McCullum (NZ),2002-2016,260,257,277,262,15,227,35,5 (5ct 0st),1.077
1256,6,IA Healy (AUS),1988-1997,168,168,233,194,39,194,0,4 (4ct 0st),1.386
1257,7,Mushfiqur Rahim (BDESH),2006-2019,216,215,225,181,44,179,2,5 (5ct 0st),1.046
1258,8,Rashid Latif (PAK),1992-2003,166,164,220,182,38,182,0,5 (5ct 0st),1.341
1259,9,DPMD Jayawardene (Asia/SL),1998-2015,448,443,218,218,0,0,218,4 (4ct 0st),0.492
1260,10,R Dravid (Asia/ICC/INDIA),1996-2011,344,341,210,196,14,72,124,4 (4ct 0st),0.615
1261,11,RS Kaluwitharana (SL),1990-2004,189,188,207,132,75,131,1,5 (4ct 1st),1.101
1262,12,PJL Dujon (WI),1981-1991,169,168,204,183,21,183,0,4 (4ct 0st),1.214
1263,13,JC Buttler (ENG),2012-2019,142,138,202,171,31,171,0,6 (6ct 0st),1.463
1264,14,RD Jacobs (WI),1996-2004,147,145,189,160,29,160,0,6 (5ct 1st),1.3030000000000002
1265,15,Kamran Akmal (PAK),2002-2017,157,154,188,157,31,156,1,5 (4ct 1st),1.22
1266,16,D Ramdin (WI),2005-2016,139,137,188,181,7,181,0,5 (5ct 0st),1.372
1267,17,AB de Villiers (Afr/SA),2005-2018,228,223,181,176,5,93,83,5 (5ct 0st),0.8109999999999999
1268,18,BJ Haddin (AUS),2001-2015,126,124,181,170,11,170,0,5 (5ct 0st),1.459
1269,19,AJ Stewart (ENG),1989-2003,170,169,174,159,15,148,11,6 (6ct 0st),1.029
1270,20,A Flower (ZIM),1992-2003,213,212,173,141,32,133,8,5 (5ct 0st),0.816
1271,21,Q de Kock (SA),2013-2019,115,111,166,158,8,158,0,6 (5ct 1st),1.495
1272,22,DJ Richardson (SA),1991-1998,122,121,165,148,17,148,0,5 (5ct 0st),1.3630000000000002
1273,23,RT Ponting (AUS/ICC),1995-2012,375,372,160,160,0,0,160,3 (3ct 0st),0.43
1274,24,M Azharuddin (INDIA),1985-2000,334,332,156,156,0,0,156,4 (4ct 0st),0.469
1275,25,NR Mongia (INDIA),1994-2000,140,139,154,110,44,110,0,5 (4ct 1st),1.107
1276,26,BRM Taylor (ZIM),2004-2019,193,193,154,125,29,96,29,5 (5ct 0st),0.797
1277,27,T Taibu (Afr/ZIM),2001-2012,150,150,147,114,33,112,2,4 (4ct 0st),0.98
1278,28,AC Parore (NZ),1992-2002,179,178,141,116,25,111,5,5 (3ct 2st),0.792
1279,29,Sarfaraz Ahmed (PAK),2007-2019,116,114,140,116,24,116,0,6 (6ct 0st),1.228
1280,30,SR Tendulkar (INDIA),1989-2012,463,456,140,140,0,0,140,4 (4ct 0st),0.307
1281,31,LRPL Taylor (NZ),2006-2019,228,224,137,137,0,0,137,4 (4ct 0st),0.611
1282,32,Younis Khan (PAK),2000-2015,265,260,135,135,0,5,130,4 (4ct 0st),0.519
1283,33,SP Fleming (ICC/NZ),1994-2007,280,276,133,133,0,0,133,4 (4ct 0st),0.481
1284,34,JH Kallis (Afr/ICC/SA),1996-2014,328,324,131,131,0,0,131,3 (3ct 0st),0.4039999999999999
1285,35,M Muralitharan (Asia/ICC/SL),1993-2011,350,347,130,130,0,0,130,3 (3ct 0st),0.374
1286,36,AR Border (AUS),1979-1994,273,270,127,127,0,0,127,3 (3ct 0st),0.47
1287,37,Shahid Afridi (Asia/ICC/PAK),1996-2015,398,392,127,127,0,0,127,2 (2ct 0st),0.3229999999999999
1288,38,Khaled Mashud (BDESH),1995-2006,126,126,126,91,35,91,0,5 (3ct 2st),1.0
1289,39,TM Dilshan (SL),1999-2016,330,325,124,123,1,5,118,3 (3ct 0st),0.381
1290,40,CH Gayle (ICC/WI),1999-2019,301,294,124,124,0,0,124,3 (3ct 0st),0.421
1291,41,V Kohli (INDIA),2008-2019,242,240,124,124,0,0,124,3 (3ct 0st),0.516
1292,42,RW Marsh (AUS),1971-1984,92,92,124,120,4,120,0,5 (5ct 0st),1.347
1293,43,ST Jayasuriya (Asia/SL),1989-2011,445,441,123,123,0,0,123,3 (3ct 0st),0.278
1294,44,CL Hooper (WI),1987-2003,227,225,120,120,0,0,120,4 (4ct 0st),0.5329999999999999
1295,45,BC Lara (ICC/WI),1990-2007,299,296,120,120,0,0,120,3 (3ct 0st),0.405
1296,46,L Ronchi (AUS/NZ),2008-2017,85,83,117,105,12,105,0,4 (4ct 0st),1.409
1297,47,MS Wade (AUS),2012-2017,94,94,117,108,9,108,0,5 (5ct 0st),1.244
1298,48,Inzamam-ul-Haq (Asia/PAK),1991-2007,378,373,113,113,0,0,113,3 (3ct 0st),0.302
1299,49,SR Waugh (AUS),1986-2002,325,324,111,111,0,0,111,3 (3ct 0st),0.342
1300,0,KC Sangakkara (Asia/ICC/SL),2000-2015,404,397,501,402,99,383,19,5 (4ct 1st),1.261
1301,1,AC Gilchrist (AUS/ICC),1996-2008,287,286,472,417,55,417,0,6 (6ct 0st),1.65
1302,2,MS Dhoni (Asia/INDIA),2004-2019,350,345,444,321,123,321,0,6 (5ct 1st),1.286
1303,3,MV Boucher (Afr/SA),1998-2011,295,291,425,403,22,402,1,6 (6ct 0st),1.46
1304,4,Moin Khan (PAK),1990-2004,219,217,287,214,73,214,0,5 (5ct 0st),1.3219999999999998
1305,5,BB McCullum (NZ),2002-2016,260,257,277,262,15,227,35,5 (5ct 0st),1.077
1306,6,IA Healy (AUS),1988-1997,168,168,233,194,39,194,0,4 (4ct 0st),1.386
1307,7,Mushfiqur Rahim (BDESH),2006-2019,216,215,225,181,44,179,2,5 (5ct 0st),1.046
1308,8,Rashid Latif (PAK),1992-2003,166,164,220,182,38,182,0,5 (5ct 0st),1.341
1309,9,DPMD Jayawardene (Asia/SL),1998-2015,448,443,218,218,0,0,218,4 (4ct 0st),0.492
1310,10,R Dravid (Asia/ICC/INDIA),1996-2011,344,341,210,196,14,72,124,4 (4ct 0st),0.615
1311,11,RS Kaluwitharana (SL),1990-2004,189,188,207,132,75,131,1,5 (4ct 1st),1.101
1312,12,PJL Dujon (WI),1981-1991,169,168,204,183,21,183,0,4 (4ct 0st),1.214
1313,13,JC Buttler (ENG),2012-2019,142,138,202,171,31,171,0,6 (6ct 0st),1.463
1314,14,RD Jacobs (WI),1996-2004,147,145,189,160,29,160,0,6 (5ct 1st),1.3030000000000002
1315,15,Kamran Akmal (PAK),2002-2017,157,154,188,157,31,156,1,5 (4ct 1st),1.22
1316,16,D Ramdin (WI),2005-2016,139,137,188,181,7,181,0,5 (5ct 0st),1.372
1317,17,AB de Villiers (Afr/SA),2005-2018,228,223,181,176,5,93,83,5 (5ct 0st),0.8109999999999999
1318,18,BJ Haddin (AUS),2001-2015,126,124,181,170,11,170,0,5 (5ct 0st),1.459
1319,19,AJ Stewart (ENG),1989-2003,170,169,174,159,15,148,11,6 (6ct 0st),1.029
1320,20,A Flower (ZIM),1992-2003,213,212,173,141,32,133,8,5 (5ct 0st),0.816
1321,21,Q de Kock (SA),2013-2019,115,111,166,158,8,158,0,6 (5ct 1st),1.495
1322,22,DJ Richardson (SA),1991-1998,122,121,165,148,17,148,0,5 (5ct 0st),1.3630000000000002
1323,23,RT Ponting (AUS/ICC),1995-2012,375,372,160,160,0,0,160,3 (3ct 0st),0.43
1324,24,M Azharuddin (INDIA),1985-2000,334,332,156,156,0,0,156,4 (4ct 0st),0.469
1325,25,NR Mongia (INDIA),1994-2000,140,139,154,110,44,110,0,5 (4ct 1st),1.107
1326,26,BRM Taylor (ZIM),2004-2019,193,193,154,125,29,96,29,5 (5ct 0st),0.797
1327,27,T Taibu (Afr/ZIM),2001-2012,150,150,147,114,33,112,2,4 (4ct 0st),0.98
1328,28,AC Parore (NZ),1992-2002,179,178,141,116,25,111,5,5 (3ct 2st),0.792
1329,29,Sarfaraz Ahmed (PAK),2007-2019,116,114,140,116,24,116,0,6 (6ct 0st),1.228
1330,30,SR Tendulkar (INDIA),1989-2012,463,456,140,140,0,0,140,4 (4ct 0st),0.307
1331,31,LRPL Taylor (NZ),2006-2019,228,224,137,137,0,0,137,4 (4ct 0st),0.611
1332,32,Younis Khan (PAK),2000-2015,265,260,135,135,0,5,130,4 (4ct 0st),0.519
1333,33,SP Fleming (ICC/NZ),1994-2007,280,276,133,133,0,0,133,4 (4ct 0st),0.481
1334,34,JH Kallis (Afr/ICC/SA),1996-2014,328,324,131,131,0,0,131,3 (3ct 0st),0.4039999999999999
1335,35,M Muralitharan (Asia/ICC/SL),1993-2011,350,347,130,130,0,0,130,3 (3ct 0st),0.374
1336,36,AR Border (AUS),1979-1994,273,270,127,127,0,0,127,3 (3ct 0st),0.47
1337,37,Shahid Afridi (Asia/ICC/PAK),1996-2015,398,392,127,127,0,0,127,2 (2ct 0st),0.3229999999999999
1338,38,Khaled Mashud (BDESH),1995-2006,126,126,126,91,35,91,0,5 (3ct 2st),1.0
1339,39,TM Dilshan (SL),1999-2016,330,325,124,123,1,5,118,3 (3ct 0st),0.381
1340,40,CH Gayle (ICC/WI),1999-2019,301,294,124,124,0,0,124,3 (3ct 0st),0.421
1341,41,V Kohli (INDIA),2008-2019,242,240,124,124,0,0,124,3 (3ct 0st),0.516
1342,42,RW Marsh (AUS),1971-1984,92,92,124,120,4,120,0,5 (5ct 0st),1.347
1343,43,ST Jayasuriya (Asia/SL),1989-2011,445,441,123,123,0,0,123,3 (3ct 0st),0.278
1344,44,CL Hooper (WI),1987-2003,227,225,120,120,0,0,120,4 (4ct 0st),0.5329999999999999
1345,45,BC Lara (ICC/WI),1990-2007,299,296,120,120,0,0,120,3 (3ct 0st),0.405
1346,46,L Ronchi (AUS/NZ),2008-2017,85,83,117,105,12,105,0,4 (4ct 0st),1.409
1347,47,MS Wade (AUS),2012-2017,94,94,117,108,9,108,0,5 (5ct 0st),1.244
1348,48,Inzamam-ul-Haq (Asia/PAK),1991-2007,378,373,113,113,0,0,113,3 (3ct 0st),0.302
1349,49,SR Waugh (AUS),1986-2002,325,324,111,111,0,0,111,3 (3ct 0st),0.342
1350,0,KC Sangakkara (Asia/ICC/SL),2000-2015,404,397,501,402,99,383,19,5 (4ct 1st),1.261
1351,1,AC Gilchrist (AUS/ICC),1996-2008,287,286,472,417,55,417,0,6 (6ct 0st),1.65
1352,2,MS Dhoni (Asia/INDIA),2004-2019,350,345,444,321,123,321,0,6 (5ct 1st),1.286
1353,3,MV Boucher (Afr/SA),1998-2011,295,291,425,403,22,402,1,6 (6ct 0st),1.46
1354,4,Moin Khan (PAK),1990-2004,219,217,287,214,73,214,0,5 (5ct 0st),1.3219999999999998
1355,5,BB McCullum (NZ),2002-2016,260,257,277,262,15,227,35,5 (5ct 0st),1.077
1356,6,IA Healy (AUS),1988-1997,168,168,233,194,39,194,0,4 (4ct 0st),1.386
1357,7,Mushfiqur Rahim (BDESH),2006-2019,216,215,225,181,44,179,2,5 (5ct 0st),1.046
1358,8,Rashid Latif (PAK),1992-2003,166,164,220,182,38,182,0,5 (5ct 0st),1.341
1359,9,DPMD Jayawardene (Asia/SL),1998-2015,448,443,218,218,0,0,218,4 (4ct 0st),0.492
1360,10,R Dravid (Asia/ICC/INDIA),1996-2011,344,341,210,196,14,72,124,4 (4ct 0st),0.615
1361,11,RS Kaluwitharana (SL),1990-2004,189,188,207,132,75,131,1,5 (4ct 1st),1.101
1362,12,PJL Dujon (WI),1981-1991,169,168,204,183,21,183,0,4 (4ct 0st),1.214
1363,13,JC Buttler (ENG),2012-2019,142,138,202,171,31,171,0,6 (6ct 0st),1.463
1364,14,RD Jacobs (WI),1996-2004,147,145,189,160,29,160,0,6 (5ct 1st),1.3030000000000002
1365,15,Kamran Akmal (PAK),2002-2017,157,154,188,157,31,156,1,5 (4ct 1st),1.22
1366,16,D Ramdin (WI),2005-2016,139,137,188,181,7,181,0,5 (5ct 0st),1.372
1367,17,AB de Villiers (Afr/SA),2005-2018,228,223,181,176,5,93,83,5 (5ct 0st),0.8109999999999999
1368,18,BJ Haddin (AUS),2001-2015,126,124,181,170,11,170,0,5 (5ct 0st),1.459
1369,19,AJ Stewart (ENG),1989-2003,170,169,174,159,15,148,11,6 (6ct 0st),1.029
1370,20,A Flower (ZIM),1992-2003,213,212,173,141,32,133,8,5 (5ct 0st),0.816
1371,21,Q de Kock (SA),2013-2019,115,111,166,158,8,158,0,6 (5ct 1st),1.495
1372,22,DJ Richardson (SA),1991-1998,122,121,165,148,17,148,0,5 (5ct 0st),1.3630000000000002
1373,23,RT Ponting (AUS/ICC),1995-2012,375,372,160,160,0,0,160,3 (3ct 0st),0.43
1374,24,M Azharuddin (INDIA),1985-2000,334,332,156,156,0,0,156,4 (4ct 0st),0.469
1375,25,NR Mongia (INDIA),1994-2000,140,139,154,110,44,110,0,5 (4ct 1st),1.107
1376,26,BRM Taylor (ZIM),2004-2019,193,193,154,125,29,96,29,5 (5ct 0st),0.797
1377,27,T Taibu (Afr/ZIM),2001-2012,150,150,147,114,33,112,2,4 (4ct 0st),0.98
1378,28,AC Parore (NZ),1992-2002,179,178,141,116,25,111,5,5 (3ct 2st),0.792
1379,29,Sarfaraz Ahmed (PAK),2007-2019,116,114,140,116,24,116,0,6 (6ct 0st),1.228
1380,30,SR Tendulkar (INDIA),1989-2012,463,456,140,140,0,0,140,4 (4ct 0st),0.307
1381,31,LRPL Taylor (NZ),2006-2019,228,224,137,137,0,0,137,4 (4ct 0st),0.611
1382,32,Younis Khan (PAK),2000-2015,265,260,135,135,0,5,130,4 (4ct 0st),0.519
1383,33,SP Fleming (ICC/NZ),1994-2007,280,276,133,133,0,0,133,4 (4ct 0st),0.481
1384,34,JH Kallis (Afr/ICC/SA),1996-2014,328,324,131,131,0,0,131,3 (3ct 0st),0.4039999999999999
1385,35,M Muralitharan (Asia/ICC/SL),1993-2011,350,347,130,130,0,0,130,3 (3ct 0st),0.374
1386,36,AR Border (AUS),1979-1994,273,270,127,127,0,0,127,3 (3ct 0st),0.47
1387,37,Shahid Afridi (Asia/ICC/PAK),1996-2015,398,392,127,127,0,0,127,2 (2ct 0st),0.3229999999999999
1388,38,Khaled Mashud (BDESH),1995-2006,126,126,126,91,35,91,0,5 (3ct 2st),1.0
1389,39,TM Dilshan (SL),1999-2016,330,325,124,123,1,5,118,3 (3ct 0st),0.381
1390,40,CH Gayle (ICC/WI),1999-2019,301,294,124,124,0,0,124,3 (3ct 0st),0.421
1391,41,V Kohli (INDIA),2008-2019,242,240,124,124,0,0,124,3 (3ct 0st),0.516
1392,42,RW Marsh (AUS),1971-1984,92,92,124,120,4,120,0,5 (5ct 0st),1.347
1393,43,ST Jayasuriya (Asia/SL),1989-2011,445,441,123,123,0,0,123,3 (3ct 0st),0.278
1394,44,CL Hooper (WI),1987-2003,227,225,120,120,0,0,120,4 (4ct 0st),0.5329999999999999
1395,45,BC Lara (ICC/WI),1990-2007,299,296,120,120,0,0,120,3 (3ct 0st),0.405
1396,46,L Ronchi (AUS/NZ),2008-2017,85,83,117,105,12,105,0,4 (4ct 0st),1.409
1397,47,MS Wade (AUS),2012-2017,94,94,117,108,9,108,0,5 (5ct 0st),1.244
1398,48,Inzamam-ul-Haq (Asia/PAK),1991-2007,378,373,113,113,0,0,113,3 (3ct 0st),0.302
1399,49,SR Waugh (AUS),1986-2002,325,324,111,111,0,0,111,3 (3ct 0st),0.342
1400,0,KC Sangakkara (Asia/ICC/SL),2000-2015,404,397,501,402,99,383,19,5 (4ct 1st),1.261
1401,1,AC Gilchrist (AUS/ICC),1996-2008,287,286,472,417,55,417,0,6 (6ct 0st),1.65
1402,2,MS Dhoni (Asia/INDIA),2004-2019,350,345,444,321,123,321,0,6 (5ct 1st),1.286
1403,3,MV Boucher (Afr/SA),1998-2011,295,291,425,403,22,402,1,6 (6ct 0st),1.46
1404,4,Moin Khan (PAK),1990-2004,219,217,287,214,73,214,0,5 (5ct 0st),1.3219999999999998
1405,5,BB McCullum (NZ),2002-2016,260,257,277,262,15,227,35,5 (5ct 0st),1.077
1406,6,IA Healy (AUS),1988-1997,168,168,233,194,39,194,0,4 (4ct 0st),1.386
1407,7,Mushfiqur Rahim (BDESH),2006-2019,216,215,225,181,44,179,2,5 (5ct 0st),1.046
1408,8,Rashid Latif (PAK),1992-2003,166,164,220,182,38,182,0,5 (5ct 0st),1.341
1409,9,DPMD Jayawardene (Asia/SL),1998-2015,448,443,218,218,0,0,218,4 (4ct 0st),0.492
1410,10,R Dravid (Asia/ICC/INDIA),1996-2011,344,341,210,196,14,72,124,4 (4ct 0st),0.615
1411,11,RS Kaluwitharana (SL),1990-2004,189,188,207,132,75,131,1,5 (4ct 1st),1.101
1412,12,PJL Dujon (WI),1981-1991,169,168,204,183,21,183,0,4 (4ct 0st),1.214
1413,13,JC Buttler (ENG),2012-2019,142,138,202,171,31,171,0,6 (6ct 0st),1.463
1414,14,RD Jacobs (WI),1996-2004,147,145,189,160,29,160,0,6 (5ct 1st),1.3030000000000002
1415,15,Kamran Akmal (PAK),2002-2017,157,154,188,157,31,156,1,5 (4ct 1st),1.22
1416,16,D Ramdin (WI),2005-2016,139,137,188,181,7,181,0,5 (5ct 0st),1.372
1417,17,AB de Villiers (Afr/SA),2005-2018,228,223,181,176,5,93,83,5 (5ct 0st),0.8109999999999999
1418,18,BJ Haddin (AUS),2001-2015,126,124,181,170,11,170,0,5 (5ct 0st),1.459
1419,19,AJ Stewart (ENG),1989-2003,170,169,174,159,15,148,11,6 (6ct 0st),1.029
1420,20,A Flower (ZIM),1992-2003,213,212,173,141,32,133,8,5 (5ct 0st),0.816
1421,21,Q de Kock (SA),2013-2019,115,111,166,158,8,158,0,6 (5ct 1st),1.495
1422,22,DJ Richardson (SA),1991-1998,122,121,165,148,17,148,0,5 (5ct 0st),1.3630000000000002
1423,23,RT Ponting (AUS/ICC),1995-2012,375,372,160,160,0,0,160,3 (3ct 0st),0.43
1424,24,M Azharuddin (INDIA),1985-2000,334,332,156,156,0,0,156,4 (4ct 0st),0.469
1425,25,NR Mongia (INDIA),1994-2000,140,139,154,110,44,110,0,5 (4ct 1st),1.107
1426,26,BRM Taylor (ZIM),2004-2019,193,193,154,125,29,96,29,5 (5ct 0st),0.797
1427,27,T Taibu (Afr/ZIM),2001-2012,150,150,147,114,33,112,2,4 (4ct 0st),0.98
1428,28,AC Parore (NZ),1992-2002,179,178,141,116,25,111,5,5 (3ct 2st),0.792
1429,29,Sarfaraz Ahmed (PAK),2007-2019,116,114,140,116,24,116,0,6 (6ct 0st),1.228
1430,30,SR Tendulkar (INDIA),1989-2012,463,456,140,140,0,0,140,4 (4ct 0st),0.307
1431,31,LRPL Taylor (NZ),2006-2019,228,224,137,137,0,0,137,4 (4ct 0st),0.611
1432,32,Younis Khan (PAK),2000-2015,265,260,135,135,0,5,130,4 (4ct 0st),0.519
1433,33,SP Fleming (ICC/NZ),1994-2007,280,276,133,133,0,0,133,4 (4ct 0st),0.481
1434,34,JH Kallis (Afr/ICC/SA),1996-2014,328,324,131,131,0,0,131,3 (3ct 0st),0.4039999999999999
1435,35,M Muralitharan (Asia/ICC/SL),1993-2011,350,347,130,130,0,0,130,3 (3ct 0st),0.374
1436,36,AR Border (AUS),1979-1994,273,270,127,127,0,0,127,3 (3ct 0st),0.47
1437,37,Shahid Afridi (Asia/ICC/PAK),1996-2015,398,392,127,127,0,0,127,2 (2ct 0st),0.3229999999999999
1438,38,Khaled Mashud (BDESH),1995-2006,126,126,126,91,35,91,0,5 (3ct 2st),1.0
1439,39,TM Dilshan (SL),1999-2016,330,325,124,123,1,5,118,3 (3ct 0st),0.381
1440,40,CH Gayle (ICC/WI),1999-2019,301,294,124,124,0,0,124,3 (3ct 0st),0.421
1441,41,V Kohli (INDIA),2008-2019,242,240,124,124,0,0,124,3 (3ct 0st),0.516
1442,42,RW Marsh (AUS),1971-1984,92,92,124,120,4,120,0,5 (5ct 0st),1.347
1443,43,ST Jayasuriya (Asia/SL),1989-2011,445,441,123,123,0,0,123,3 (3ct 0st),0.278
1444,44,CL Hooper (WI),1987-2003,227,225,120,120,0,0,120,4 (4ct 0st),0.5329999999999999
1445,45,BC Lara (ICC/WI),1990-2007,299,296,120,120,0,0,120,3 (3ct 0st),0.405
1446,46,L Ronchi (AUS/NZ),2008-2017,85,83,117,105,12,105,0,4 (4ct 0st),1.409
1447,47,MS Wade (AUS),2012-2017,94,94,117,108,9,108,0,5 (5ct 0st),1.244
1448,48,Inzamam-ul-Haq (Asia/PAK),1991-2007,378,373,113,113,0,0,113,3 (3ct 0st),0.302
1449,49,SR Waugh (AUS),1986-2002,325,324,111,111,0,0,111,3 (3ct 0st),0.342
1450,0,KC Sangakkara (Asia/ICC/SL),2000-2015,404,397,501,402,99,383,19,5 (4ct 1st),1.261
1451,1,AC Gilchrist (AUS/ICC),1996-2008,287,286,472,417,55,417,0,6 (6ct 0st),1.65
1452,2,MS Dhoni (Asia/INDIA),2004-2019,350,345,444,321,123,321,0,6 (5ct 1st),1.286
1453,3,MV Boucher (Afr/SA),1998-2011,295,291,425,403,22,402,1,6 (6ct 0st),1.46
1454,4,Moin Khan (PAK),1990-2004,219,217,287,214,73,214,0,5 (5ct 0st),1.3219999999999998
1455,5,BB McCullum (NZ),2002-2016,260,257,277,262,15,227,35,5 (5ct 0st),1.077
1456,6,IA Healy (AUS),1988-1997,168,168,233,194,39,194,0,4 (4ct 0st),1.386
1457,7,Mushfiqur Rahim (BDESH),2006-2019,216,215,225,181,44,179,2,5 (5ct 0st),1.046
1458,8,Rashid Latif (PAK),1992-2003,166,164,220,182,38,182,0,5 (5ct 0st),1.341
1459,9,DPMD Jayawardene (Asia/SL),1998-2015,448,443,218,218,0,0,218,4 (4ct 0st),0.492
1460,10,R Dravid (Asia/ICC/INDIA),1996-2011,344,341,210,196,14,72,124,4 (4ct 0st),0.615
1461,11,RS Kaluwitharana (SL),1990-2004,189,188,207,132,75,131,1,5 (4ct 1st),1.101
1462,12,PJL Dujon (WI),1981-1991,169,168,204,183,21,183,0,4 (4ct 0st),1.214
1463,13,JC Buttler (ENG),2012-2019,142,138,202,171,31,171,0,6 (6ct 0st),1.463
1464,14,RD Jacobs (WI),1996-2004,147,145,189,160,29,160,0,6 (5ct 1st),1.3030000000000002
1465,15,Kamran Akmal (PAK),2002-2017,157,154,188,157,31,156,1,5 (4ct 1st),1.22
1466,16,D Ramdin (WI),2005-2016,139,137,188,181,7,181,0,5 (5ct 0st),1.372
1467,17,AB de Villiers (Afr/SA),2005-2018,228,223,181,176,5,93,83,5 (5ct 0st),0.8109999999999999
1468,18,BJ Haddin (AUS),2001-2015,126,124,181,170,11,170,0,5 (5ct 0st),1.459
1469,19,AJ Stewart (ENG),1989-2003,170,169,174,159,15,148,11,6 (6ct 0st),1.029
1470,20,A Flower (ZIM),1992-2003,213,212,173,141,32,133,8,5 (5ct 0st),0.816
1471,21,Q de Kock (SA),2013-2019,115,111,166,158,8,158,0,6 (5ct 1st),1.495
1472,22,DJ Richardson (SA),1991-1998,122,121,165,148,17,148,0,5 (5ct 0st),1.3630000000000002
1473,23,RT Ponting (AUS/ICC),1995-2012,375,372,160,160,0,0,160,3 (3ct 0st),0.43
1474,24,M Azharuddin (INDIA),1985-2000,334,332,156,156,0,0,156,4 (4ct 0st),0.469
1475,25,NR Mongia (INDIA),1994-2000,140,139,154,110,44,110,0,5 (4ct 1st),1.107
1476,26,BRM Taylor (ZIM),2004-2019,193,193,154,125,29,96,29,5 (5ct 0st),0.797
1477,27,T Taibu (Afr/ZIM),2001-2012,150,150,147,114,33,112,2,4 (4ct 0st),0.98
1478,28,AC Parore (NZ),1992-2002,179,178,141,116,25,111,5,5 (3ct 2st),0.792
1479,29,Sarfaraz Ahmed (PAK),2007-2019,116,114,140,116,24,116,0,6 (6ct 0st),1.228
1480,30,SR Tendulkar (INDIA),1989-2012,463,456,140,140,0,0,140,4 (4ct 0st),0.307
1481,31,LRPL Taylor (NZ),2006-2019,228,224,137,137,0,0,137,4 (4ct 0st),0.611
1482,32,Younis Khan (PAK),2000-2015,265,260,135,135,0,5,130,4 (4ct 0st),0.519
1483,33,SP Fleming (ICC/NZ),1994-2007,280,276,133,133,0,0,133,4 (4ct 0st),0.481
1484,34,JH Kallis (Afr/ICC/SA),1996-2014,328,324,131,131,0,0,131,3 (3ct 0st),0.4039999999999999
1485,35,M Muralitharan (Asia/ICC/SL),1993-2011,350,347,130,130,0,0,130,3 (3ct 0st),0.374
1486,36,AR Border (AUS),1979-1994,273,270,127,127,0,0,127,3 (3ct 0st),0.47
1487,37,Shahid Afridi (Asia/ICC/PAK),1996-2015,398,392,127,127,0,0,127,2 (2ct 0st),0.3229999999999999
1488,38,Khaled Mashud (BDESH),1995-2006,126,126,126,91,35,91,0,5 (3ct 2st),1.0
1489,39,TM Dilshan (SL),1999-2016,330,325,124,123,1,5,118,3 (3ct 0st),0.381
1490,40,CH Gayle (ICC/WI),1999-2019,301,294,124,124,0,0,124,3 (3ct 0st),0.421
1491,41,V Kohli (INDIA),2008-2019,242,240,124,124,0,0,124,3 (3ct 0st),0.516
1492,42,RW Marsh (AUS),1971-1984,92,92,124,120,4,120,0,5 (5ct 0st),1.347
1493,43,ST Jayasuriya (Asia/SL),1989-2011,445,441,123,123,0,0,123,3 (3ct 0st),0.278
1494,44,CL Hooper (WI),1987-2003,227,225,120,120,0,0,120,4 (4ct 0st),0.5329999999999999
1495,45,BC Lara (ICC/WI),1990-2007,299,296,120,120,0,0,120,3 (3ct 0st),0.405
1496,46,L Ronchi (AUS/NZ),2008-2017,85,83,117,105,12,105,0,4 (4ct 0st),1.409
1497,47,MS Wade (AUS),2012-2017,94,94,117,108,9,108,0,5 (5ct 0st),1.244
1498,48,Inzamam-ul-Haq (Asia/PAK),1991-2007,378,373,113,113,0,0,113,3 (3ct 0st),0.302
1499,49,SR Waugh (AUS),1986-2002,325,324,111,111,0,0,111,3 (3ct 0st),0.342
1500,0,KC Sangakkara (Asia/ICC/SL),2000-2015,404,397,501,402,99,383,19,5 (4ct 1st),1.261
1501,1,AC Gilchrist (AUS/ICC),1996-2008,287,286,472,417,55,417,0,6 (6ct 0st),1.65
1502,2,MS Dhoni (Asia/INDIA),2004-2019,350,345,444,321,123,321,0,6 (5ct 1st),1.286
1503,3,MV Boucher (Afr/SA),1998-2011,295,291,425,403,22,402,1,6 (6ct 0st),1.46
1504,4,Moin Khan (PAK),1990-2004,219,217,287,214,73,214,0,5 (5ct 0st),1.3219999999999998
1505,5,BB McCullum (NZ),2002-2016,260,257,277,262,15,227,35,5 (5ct 0st),1.077
1506,6,IA Healy (AUS),1988-1997,168,168,233,194,39,194,0,4 (4ct 0st),1.386
1507,7,Mushfiqur Rahim (BDESH),2006-2019,216,215,225,181,44,179,2,5 (5ct 0st),1.046
1508,8,Rashid Latif (PAK),1992-2003,166,164,220,182,38,182,0,5 (5ct 0st),1.341
1509,9,DPMD Jayawardene (Asia/SL),1998-2015,448,443,218,218,0,0,218,4 (4ct 0st),0.492
1510,10,R Dravid (Asia/ICC/INDIA),1996-2011,344,341,210,196,14,72,124,4 (4ct 0st),0.615
1511,11,RS Kaluwitharana (SL),1990-2004,189,188,207,132,75,131,1,5 (4ct 1st),1.101
1512,12,PJL Dujon (WI),1981-1991,169,168,204,183,21,183,0,4 (4ct 0st),1.214
1513,13,JC Buttler (ENG),2012-2019,142,138,202,171,31,171,0,6 (6ct 0st),1.463
1514,14,RD Jacobs (WI),1996-2004,147,145,189,160,29,160,0,6 (5ct 1st),1.3030000000000002
1515,15,Kamran Akmal (PAK),2002-2017,157,154,188,157,31,156,1,5 (4ct 1st),1.22
1516,16,D Ramdin (WI),2005-2016,139,137,188,181,7,181,0,5 (5ct 0st),1.372
1517,17,AB de Villiers (Afr/SA),2005-2018,228,223,181,176,5,93,83,5 (5ct 0st),0.8109999999999999
1518,18,BJ Haddin (AUS),2001-2015,126,124,181,170,11,170,0,5 (5ct 0st),1.459
1519,19,AJ Stewart (ENG),1989-2003,170,169,174,159,15,148,11,6 (6ct 0st),1.029
1520,20,A Flower (ZIM),1992-2003,213,212,173,141,32,133,8,5 (5ct 0st),0.816
1521,21,Q de Kock (SA),2013-2019,115,111,166,158,8,158,0,6 (5ct 1st),1.495
1522,22,DJ Richardson (SA),1991-1998,122,121,165,148,17,148,0,5 (5ct 0st),1.3630000000000002
1523,23,RT Ponting (AUS/ICC),1995-2012,375,372,160,160,0,0,160,3 (3ct 0st),0.43
1524,24,M Azharuddin (INDIA),1985-2000,334,332,156,156,0,0,156,4 (4ct 0st),0.469
1525,25,NR Mongia (INDIA),1994-2000,140,139,154,110,44,110,0,5 (4ct 1st),1.107
1526,26,BRM Taylor (ZIM),2004-2019,193,193,154,125,29,96,29,5 (5ct 0st),0.797
1527,27,T Taibu (Afr/ZIM),2001-2012,150,150,147,114,33,112,2,4 (4ct 0st),0.98
1528,28,AC Parore (NZ),1992-2002,179,178,141,116,25,111,5,5 (3ct 2st),0.792
1529,29,Sarfaraz Ahmed (PAK),2007-2019,116,114,140,116,24,116,0,6 (6ct 0st),1.228
1530,30,SR Tendulkar (INDIA),1989-2012,463,456,140,140,0,0,140,4 (4ct 0st),0.307
1531,31,LRPL Taylor (NZ),2006-2019,228,224,137,137,0,0,137,4 (4ct 0st),0.611
1532,32,Younis Khan (PAK),2000-2015,265,260,135,135,0,5,130,4 (4ct 0st),0.519
1533,33,SP Fleming (ICC/NZ),1994-2007,280,276,133,133,0,0,133,4 (4ct 0st),0.481
1534,34,JH Kallis (Afr/ICC/SA),1996-2014,328,324,131,131,0,0,131,3 (3ct 0st),0.4039999999999999
1535,35,M Muralitharan (Asia/ICC/SL),1993-2011,350,347,130,130,0,0,130,3 (3ct 0st),0.374
1536,36,AR Border (AUS),1979-1994,273,270,127,127,0,0,127,3 (3ct 0st),0.47
1537,37,Shahid Afridi (Asia/ICC/PAK),1996-2015,398,392,127,127,0,0,127,2 (2ct 0st),0.3229999999999999
1538,38,Khaled Mashud (BDESH),1995-2006,126,126,126,91,35,91,0,5 (3ct 2st),1.0
1539,39,TM Dilshan (SL),1999-2016,330,325,124,123,1,5,118,3 (3ct 0st),0.381
1540,40,CH Gayle (ICC/WI),1999-2019,301,294,124,124,0,0,124,3 (3ct 0st),0.421
1541,41,V Kohli (INDIA),2008-2019,242,240,124,124,0,0,124,3 (3ct 0st),0.516
1542,42,RW Marsh (AUS),1971-1984,92,92,124,120,4,120,0,5 (5ct 0st),1.347
1543,43,ST Jayasuriya (Asia/SL),1989-2011,445,441,123,123,0,0,123,3 (3ct 0st),0.278
1544,44,CL Hooper (WI),1987-2003,227,225,120,120,0,0,120,4 (4ct 0st),0.5329999999999999
1545,45,BC Lara (ICC/WI),1990-2007,299,296,120,120,0,0,120,3 (3ct 0st),0.405
1546,46,L Ronchi (AUS/NZ),2008-2017,85,83,117,105,12,105,0,4 (4ct 0st),1.409
1547,47,MS Wade (AUS),2012-2017,94,94,117,108,9,108,0,5 (5ct 0st),1.244
1548,48,Inzamam-ul-Haq (Asia/PAK),1991-2007,378,373,113,113,0,0,113,3 (3ct 0st),0.302
1549,49,SR Waugh (AUS),1986-2002,325,324,111,111,0,0,111,3 (3ct 0st),0.342
1550,0,KC Sangakkara (Asia/ICC/SL),2000-2015,404,397,501,402,99,383,19,5 (4ct 1st),1.261
1551,1,AC Gilchrist (AUS/ICC),1996-2008,287,286,472,417,55,417,0,6 (6ct 0st),1.65
1552,2,MS Dhoni (Asia/INDIA),2004-2019,350,345,444,321,123,321,0,6 (5ct 1st),1.286
1553,3,MV Boucher (Afr/SA),1998-2011,295,291,425,403,22,402,1,6 (6ct 0st),1.46
1554,4,Moin Khan (PAK),1990-2004,219,217,287,214,73,214,0,5 (5ct 0st),1.3219999999999998
1555,5,BB McCullum (NZ),2002-2016,260,257,277,262,15,227,35,5 (5ct 0st),1.077
1556,6,IA Healy (AUS),1988-1997,168,168,233,194,39,194,0,4 (4ct 0st),1.386
1557,7,Mushfiqur Rahim (BDESH),2006-2019,216,215,225,181,44,179,2,5 (5ct 0st),1.046
1558,8,Rashid Latif (PAK),1992-2003,166,164,220,182,38,182,0,5 (5ct 0st),1.341
1559,9,DPMD Jayawardene (Asia/SL),1998-2015,448,443,218,218,0,0,218,4 (4ct 0st),0.492
1560,10,R Dravid (Asia/ICC/INDIA),1996-2011,344,341,210,196,14,72,124,4 (4ct 0st),0.615
1561,11,RS Kaluwitharana (SL),1990-2004,189,188,207,132,75,131,1,5 (4ct 1st),1.101
1562,12,PJL Dujon (WI),1981-1991,169,168,204,183,21,183,0,4 (4ct 0st),1.214
1563,13,JC Buttler (ENG),2012-2019,142,138,202,171,31,171,0,6 (6ct 0st),1.463
1564,14,RD Jacobs (WI),1996-2004,147,145,189,160,29,160,0,6 (5ct 1st),1.3030000000000002
1565,15,Kamran Akmal (PAK),2002-2017,157,154,188,157,31,156,1,5 (4ct 1st),1.22
1566,16,D Ramdin (WI),2005-2016,139,137,188,181,7,181,0,5 (5ct 0st),1.372
1567,17,AB de Villiers (Afr/SA),2005-2018,228,223,181,176,5,93,83,5 (5ct 0st),0.8109999999999999
1568,18,BJ Haddin (AUS),2001-2015,126,124,181,170,11,170,0,5 (5ct 0st),1.459
1569,19,AJ Stewart (ENG),1989-2003,170,169,174,159,15,148,11,6 (6ct 0st),1.029
1570,20,A Flower (ZIM),1992-2003,213,212,173,141,32,133,8,5 (5ct 0st),0.816
1571,21,Q de Kock (SA),2013-2019,115,111,166,158,8,158,0,6 (5ct 1st),1.495
1572,22,DJ Richardson (SA),1991-1998,122,121,165,148,17,148,0,5 (5ct 0st),1.3630000000000002
1573,23,RT Ponting (AUS/ICC),1995-2012,375,372,160,160,0,0,160,3 (3ct 0st),0.43
1574,24,M Azharuddin (INDIA),1985-2000,334,332,156,156,0,0,156,4 (4ct 0st),0.469
1575,25,NR Mongia (INDIA),1994-2000,140,139,154,110,44,110,0,5 (4ct 1st),1.107
1576,26,BRM Taylor (ZIM),2004-2019,193,193,154,125,29,96,29,5 (5ct 0st),0.797
1577,27,T Taibu (Afr/ZIM),2001-2012,150,150,147,114,33,112,2,4 (4ct 0st),0.98
1578,28,AC Parore (NZ),1992-2002,179,178,141,116,25,111,5,5 (3ct 2st),0.792
1579,29,Sarfaraz Ahmed (PAK),2007-2019,116,114,140,116,24,116,0,6 (6ct 0st),1.228
1580,30,SR Tendulkar (INDIA),1989-2012,463,456,140,140,0,0,140,4 (4ct 0st),0.307
1581,31,LRPL Taylor (NZ),2006-2019,228,224,137,137,0,0,137,4 (4ct 0st),0.611
1582,32,Younis Khan (PAK),2000-2015,265,260,135,135,0,5,130,4 (4ct 0st),0.519
1583,33,SP Fleming (ICC/NZ),1994-2007,280,276,133,133,0,0,133,4 (4ct 0st),0.481
1584,34,JH Kallis (Afr/ICC/SA),1996-2014,328,324,131,131,0,0,131,3 (3ct 0st),0.4039999999999999
1585,35,M Muralitharan (Asia/ICC/SL),1993-2011,350,347,130,130,0,0,130,3 (3ct 0st),0.374
1586,36,AR Border (AUS),1979-1994,273,270,127,127,0,0,127,3 (3ct 0st),0.47
1587,37,Shahid Afridi (Asia/ICC/PAK),1996-2015,398,392,127,127,0,0,127,2 (2ct 0st),0.3229999999999999
1588,38,Khaled Mashud (BDESH),1995-2006,126,126,126,91,35,91,0,5 (3ct 2st),1.0
1589,39,TM Dilshan (SL),1999-2016,330,325,124,123,1,5,118,3 (3ct 0st),0.381
1590,40,CH Gayle (ICC/WI),1999-2019,301,294,124,124,0,0,124,3 (3ct 0st),0.421
1591,41,V Kohli (INDIA),2008-2019,242,240,124,124,0,0,124,3 (3ct 0st),0.516
1592,42,RW Marsh (AUS),1971-1984,92,92,124,120,4,120,0,5 (5ct 0st),1.347
1593,43,ST Jayasuriya (Asia/SL),1989-2011,445,441,123,123,0,0,123,3 (3ct 0st),0.278
1594,44,CL Hooper (WI),1987-2003,227,225,120,120,0,0,120,4 (4ct 0st),0.5329999999999999
1595,45,BC Lara (ICC/WI),1990-2007,299,296,120,120,0,0,120,3 (3ct 0st),0.405
1596,46,L Ronchi (AUS/NZ),2008-2017,85,83,117,105,12,105,0,4 (4ct 0st),1.409
1597,47,MS Wade (AUS),2012-2017,94,94,117,108,9,108,0,5 (5ct 0st),1.244
1598,48,Inzamam-ul-Haq (Asia/PAK),1991-2007,378,373,113,113,0,0,113,3 (3ct 0st),0.302
1599,49,SR Waugh (AUS),1986-2002,325,324,111,111,0,0,111,3 (3ct 0st),0.342
1600,0,KC Sangakkara (Asia/ICC/SL),2000-2015,404,397,501,402,99,383,19,5 (4ct 1st),1.261
1601,1,AC Gilchrist (AUS/ICC),1996-2008,287,286,472,417,55,417,0,6 (6ct 0st),1.65
1602,2,MS Dhoni (Asia/INDIA),2004-2019,350,345,444,321,123,321,0,6 (5ct 1st),1.286
1603,3,MV Boucher (Afr/SA),1998-2011,295,291,425,403,22,402,1,6 (6ct 0st),1.46
1604,4,Moin Khan (PAK),1990-2004,219,217,287,214,73,214,0,5 (5ct 0st),1.3219999999999998
1605,5,BB McCullum (NZ),2002-2016,260,257,277,262,15,227,35,5 (5ct 0st),1.077
1606,6,IA Healy (AUS),1988-1997,168,168,233,194,39,194,0,4 (4ct 0st),1.386
1607,7,Mushfiqur Rahim (BDESH),2006-2019,216,215,225,181,44,179,2,5 (5ct 0st),1.046
1608,8,Rashid Latif (PAK),1992-2003,166,164,220,182,38,182,0,5 (5ct 0st),1.341
1609,9,DPMD Jayawardene (Asia/SL),1998-2015,448,443,218,218,0,0,218,4 (4ct 0st),0.492
1610,10,R Dravid (Asia/ICC/INDIA),1996-2011,344,341,210,196,14,72,124,4 (4ct 0st),0.615
1611,11,RS Kaluwitharana (SL),1990-2004,189,188,207,132,75,131,1,5 (4ct 1st),1.101
1612,12,PJL Dujon (WI),1981-1991,169,168,204,183,21,183,0,4 (4ct 0st),1.214
1613,13,JC Buttler (ENG),2012-2019,142,138,202,171,31,171,0,6 (6ct 0st),1.463
1614,14,RD Jacobs (WI),1996-2004,147,145,189,160,29,160,0,6 (5ct 1st),1.3030000000000002
1615,15,Kamran Akmal (PAK),2002-2017,157,154,188,157,31,156,1,5 (4ct 1st),1.22
1616,16,D Ramdin (WI),2005-2016,139,137,188,181,7,181,0,5 (5ct 0st),1.372
1617,17,AB de Villiers (Afr/SA),2005-2018,228,223,181,176,5,93,83,5 (5ct 0st),0.8109999999999999
1618,18,BJ Haddin (AUS),2001-2015,126,124,181,170,11,170,0,5 (5ct 0st),1.459
1619,19,AJ Stewart (ENG),1989-2003,170,169,174,159,15,148,11,6 (6ct 0st),1.029
1620,20,A Flower (ZIM),1992-2003,213,212,173,141,32,133,8,5 (5ct 0st),0.816
1621,21,Q de Kock (SA),2013-2019,115,111,166,158,8,158,0,6 (5ct 1st),1.495
1622,22,DJ Richardson (SA),1991-1998,122,121,165,148,17,148,0,5 (5ct 0st),1.3630000000000002
1623,23,RT Ponting (AUS/ICC),1995-2012,375,372,160,160,0,0,160,3 (3ct 0st),0.43
1624,24,M Azharuddin (INDIA),1985-2000,334,332,156,156,0,0,156,4 (4ct 0st),0.469
1625,25,NR Mongia (INDIA),1994-2000,140,139,154,110,44,110,0,5 (4ct 1st),1.107
1626,26,BRM Taylor (ZIM),2004-2019,193,193,154,125,29,96,29,5 (5ct 0st),0.797
1627,27,T Taibu (Afr/ZIM),2001-2012,150,150,147,114,33,112,2,4 (4ct 0st),0.98
1628,28,AC Parore (NZ),1992-2002,179,178,141,116,25,111,5,5 (3ct 2st),0.792
1629,29,Sarfaraz Ahmed (PAK),2007-2019,116,114,140,116,24,116,0,6 (6ct 0st),1.228
1630,30,SR Tendulkar (INDIA),1989-2012,463,456,140,140,0,0,140,4 (4ct 0st),0.307
1631,31,LRPL Taylor (NZ),2006-2019,228,224,137,137,0,0,137,4 (4ct 0st),0.611
1632,32,Younis Khan (PAK),2000-2015,265,260,135,135,0,5,130,4 (4ct 0st),0.519
1633,33,SP Fleming (ICC/NZ),1994-2007,280,276,133,133,0,0,133,4 (4ct 0st),0.481
1634,34,JH Kallis (Afr/ICC/SA),1996-2014,328,324,131,131,0,0,131,3 (3ct 0st),0.4039999999999999
1635,35,M Muralitharan (Asia/ICC/SL),1993-2011,350,347,130,130,0,0,130,3 (3ct 0st),0.374
1636,36,AR Border (AUS),1979-1994,273,270,127,127,0,0,127,3 (3ct 0st),0.47
1637,37,Shahid Afridi (Asia/ICC/PAK),1996-2015,398,392,127,127,0,0,127,2 (2ct 0st),0.3229999999999999
1638,38,Khaled Mashud (BDESH),1995-2006,126,126,126,91,35,91,0,5 (3ct 2st),1.0
1639,39,TM Dilshan (SL),1999-2016,330,325,124,123,1,5,118,3 (3ct 0st),0.381
1640,40,CH Gayle (ICC/WI),1999-2019,301,294,124,124,0,0,124,3 (3ct 0st),0.421
1641,41,V Kohli (INDIA),2008-2019,242,240,124,124,0,0,124,3 (3ct 0st),0.516
1642,42,RW Marsh (AUS),1971-1984,92,92,124,120,4,120,0,5 (5ct 0st),1.347
1643,43,ST Jayasuriya (Asia/SL),1989-2011,445,441,123,123,0,0,123,3 (3ct 0st),0.278
1644,44,CL Hooper (WI),1987-2003,227,225,120,120,0,0,120,4 (4ct 0st),0.5329999999999999
1645,45,BC Lara (ICC/WI),1990-2007,299,296,120,120,0,0,120,3 (3ct 0st),0.405
1646,46,L Ronchi (AUS/NZ),2008-2017,85,83,117,105,12,105,0,4 (4ct 0st),1.409
1647,47,MS Wade (AUS),2012-2017,94,94,117,108,9,108,0,5 (5ct 0st),1.244
1648,48,Inzamam-ul-Haq (Asia/PAK),1991-2007,378,373,113,113,0,0,113,3 (3ct 0st),0.302
1649,49,SR Waugh (AUS),1986-2002,325,324,111,111,0,0,111,3 (3ct 0st),0.342
1650,0,KC Sangakkara (Asia/ICC/SL),2000-2015,404,397,501,402,99,383,19,5 (4ct 1st),1.261
1651,1,AC Gilchrist (AUS/ICC),1996-2008,287,286,472,417,55,417,0,6 (6ct 0st),1.65
1652,2,MS Dhoni (Asia/INDIA),2004-2019,350,345,444,321,123,321,0,6 (5ct 1st),1.286
1653,3,MV Boucher (Afr/SA),1998-2011,295,291,425,403,22,402,1,6 (6ct 0st),1.46
1654,4,Moin Khan (PAK),1990-2004,219,217,287,214,73,214,0,5 (5ct 0st),1.3219999999999998
1655,5,BB McCullum (NZ),2002-2016,260,257,277,262,15,227,35,5 (5ct 0st),1.077
1656,6,IA Healy (AUS),1988-1997,168,168,233,194,39,194,0,4 (4ct 0st),1.386
1657,7,Mushfiqur Rahim (BDESH),2006-2019,216,215,225,181,44,179,2,5 (5ct 0st),1.046
1658,8,Rashid Latif (PAK),1992-2003,166,164,220,182,38,182,0,5 (5ct 0st),1.341
1659,9,DPMD Jayawardene (Asia/SL),1998-2015,448,443,218,218,0,0,218,4 (4ct 0st),0.492
1660,10,R Dravid (Asia/ICC/INDIA),1996-2011,344,341,210,196,14,72,124,4 (4ct 0st),0.615
1661,11,RS Kaluwitharana (SL),1990-2004,189,188,207,132,75,131,1,5 (4ct 1st),1.101
1662,12,PJL Dujon (WI),1981-1991,169,168,204,183,21,183,0,4 (4ct 0st),1.214
1663,13,JC Buttler (ENG),2012-2019,142,138,202,171,31,171,0,6 (6ct 0st),1.463
1664,14,RD Jacobs (WI),1996-2004,147,145,189,160,29,160,0,6 (5ct 1st),1.3030000000000002
1665,15,Kamran Akmal (PAK),2002-2017,157,154,188,157,31,156,1,5 (4ct 1st),1.22
1666,16,D Ramdin (WI),2005-2016,139,137,188,181,7,181,0,5 (5ct 0st),1.372
1667,17,AB de Villiers (Afr/SA),2005-2018,228,223,181,176,5,93,83,5 (5ct 0st),0.8109999999999999
1668,18,BJ Haddin (AUS),2001-2015,126,124,181,170,11,170,0,5 (5ct 0st),1.459
1669,19,AJ Stewart (ENG),1989-2003,170,169,174,159,15,148,11,6 (6ct 0st),1.029
1670,20,A Flower (ZIM),1992-2003,213,212,173,141,32,133,8,5 (5ct 0st),0.816
1671,21,Q de Kock (SA),2013-2019,115,111,166,158,8,158,0,6 (5ct 1st),1.495
1672,22,DJ Richardson (SA),1991-1998,122,121,165,148,17,148,0,5 (5ct 0st),1.3630000000000002
1673,23,RT Ponting (AUS/ICC),1995-2012,375,372,160,160,0,0,160,3 (3ct 0st),0.43
1674,24,M Azharuddin (INDIA),1985-2000,334,332,156,156,0,0,156,4 (4ct 0st),0.469
1675,25,NR Mongia (INDIA),1994-2000,140,139,154,110,44,110,0,5 (4ct 1st),1.107
1676,26,BRM Taylor (ZIM),2004-2019,193,193,154,125,29,96,29,5 (5ct 0st),0.797
1677,27,T Taibu (Afr/ZIM),2001-2012,150,150,147,114,33,112,2,4 (4ct 0st),0.98
1678,28,AC Parore (NZ),1992-2002,179,178,141,116,25,111,5,5 (3ct 2st),0.792
1679,29,Sarfaraz Ahmed (PAK),2007-2019,116,114,140,116,24,116,0,6 (6ct 0st),1.228
1680,30,SR Tendulkar (INDIA),1989-2012,463,456,140,140,0,0,140,4 (4ct 0st),0.307
1681,31,LRPL Taylor (NZ),2006-2019,228,224,137,137,0,0,137,4 (4ct 0st),0.611
1682,32,Younis Khan (PAK),2000-2015,265,260,135,135,0,5,130,4 (4ct 0st),0.519
1683,33,SP Fleming (ICC/NZ),1994-2007,280,276,133,133,0,0,133,4 (4ct 0st),0.481
1684,34,JH Kallis (Afr/ICC/SA),1996-2014,328,324,131,131,0,0,131,3 (3ct 0st),0.4039999999999999
1685,35,M Muralitharan (Asia/ICC/SL),1993-2011,350,347,130,130,0,0,130,3 (3ct 0st),0.374
1686,36,AR Border (AUS),1979-1994,273,270,127,127,0,0,127,3 (3ct 0st),0.47
1687,37,Shahid Afridi (Asia/ICC/PAK),1996-2015,398,392,127,127,0,0,127,2 (2ct 0st),0.3229999999999999
1688,38,Khaled Mashud (BDESH),1995-2006,126,126,126,91,35,91,0,5 (3ct 2st),1.0
1689,39,TM Dilshan (SL),1999-2016,330,325,124,123,1,5,118,3 (3ct 0st),0.381
1690,40,CH Gayle (ICC/WI),1999-2019,301,294,124,124,0,0,124,3 (3ct 0st),0.421
1691,41,V Kohli (INDIA),2008-2019,242,240,124,124,0,0,124,3 (3ct 0st),0.516
1692,42,RW Marsh (AUS),1971-1984,92,92,124,120,4,120,0,5 (5ct 0st),1.347
1693,43,ST Jayasuriya (Asia/SL),1989-2011,445,441,123,123,0,0,123,3 (3ct 0st),0.278
1694,44,CL Hooper (WI),1987-2003,227,225,120,120,0,0,120,4 (4ct 0st),0.5329999999999999
1695,45,BC Lara (ICC/WI),1990-2007,299,296,120,120,0,0,120,3 (3ct 0st),0.405
1696,46,L Ronchi (AUS/NZ),2008-2017,85,83,117,105,12,105,0,4 (4ct 0st),1.409
1697,47,MS Wade (AUS),2012-2017,94,94,117,108,9,108,0,5 (5ct 0st),1.244
1698,48,Inzamam-ul-Haq (Asia/PAK),1991-2007,378,373,113,113,0,0,113,3 (3ct 0st),0.302
1699,49,SR Waugh (AUS),1986-2002,325,324,111,111,0,0,111,3 (3ct 0st),0.342
1700,0,KC Sangakkara (Asia/ICC/SL),2000-2015,404,397,501,402,99,383,19,5 (4ct 1st),1.261
1701,1,AC Gilchrist (AUS/ICC),1996-2008,287,286,472,417,55,417,0,6 (6ct 0st),1.65
1702,2,MS Dhoni (Asia/INDIA),2004-2019,350,345,444,321,123,321,0,6 (5ct 1st),1.286
1703,3,MV Boucher (Afr/SA),1998-2011,295,291,425,403,22,402,1,6 (6ct 0st),1.46
1704,4,Moin Khan (PAK),1990-2004,219,217,287,214,73,214,0,5 (5ct 0st),1.3219999999999998
1705,5,BB McCullum (NZ),2002-2016,260,257,277,262,15,227,35,5 (5ct 0st),1.077
1706,6,IA Healy (AUS),1988-1997,168,168,233,194,39,194,0,4 (4ct 0st),1.386
1707,7,Mushfiqur Rahim (BDESH),2006-2019,216,215,225,181,44,179,2,5 (5ct 0st),1.046
1708,8,Rashid Latif (PAK),1992-2003,166,164,220,182,38,182,0,5 (5ct 0st),1.341
1709,9,DPMD Jayawardene (Asia/SL),1998-2015,448,443,218,218,0,0,218,4 (4ct 0st),0.492
1710,10,R Dravid (Asia/ICC/INDIA),1996-2011,344,341,210,196,14,72,124,4 (4ct 0st),0.615
1711,11,RS Kaluwitharana (SL),1990-2004,189,188,207,132,75,131,1,5 (4ct 1st),1.101
1712,12,PJL Dujon (WI),1981-1991,169,168,204,183,21,183,0,4 (4ct 0st),1.214
1713,13,JC Buttler (ENG),2012-2019,142,138,202,171,31,171,0,6 (6ct 0st),1.463
1714,14,RD Jacobs (WI),1996-2004,147,145,189,160,29,160,0,6 (5ct 1st),1.3030000000000002
1715,15,Kamran Akmal (PAK),2002-2017,157,154,188,157,31,156,1,5 (4ct 1st),1.22
1716,16,D Ramdin (WI),2005-2016,139,137,188,181,7,181,0,5 (5ct 0st),1.372
1717,17,AB de Villiers (Afr/SA),2005-2018,228,223,181,176,5,93,83,5 (5ct 0st),0.8109999999999999
1718,18,BJ Haddin (AUS),2001-2015,126,124,181,170,11,170,0,5 (5ct 0st),1.459
1719,19,AJ Stewart (ENG),1989-2003,170,169,174,159,15,148,11,6 (6ct 0st),1.029
1720,20,A Flower (ZIM),1992-2003,213,212,173,141,32,133,8,5 (5ct 0st),0.816
1721,21,Q de Kock (SA),2013-2019,115,111,166,158,8,158,0,6 (5ct 1st),1.495
1722,22,DJ Richardson (SA),1991-1998,122,121,165,148,17,148,0,5 (5ct 0st),1.3630000000000002
1723,23,RT Ponting (AUS/ICC),1995-2012,375,372,160,160,0,0,160,3 (3ct 0st),0.43
1724,24,M Azharuddin (INDIA),1985-2000,334,332,156,156,0,0,156,4 (4ct 0st),0.469
1725,25,NR Mongia (INDIA),1994-2000,140,139,154,110,44,110,0,5 (4ct 1st),1.107
1726,26,BRM Taylor (ZIM),2004-2019,193,193,154,125,29,96,29,5 (5ct 0st),0.797
1727,27,T Taibu (Afr/ZIM),2001-2012,150,150,147,114,33,112,2,4 (4ct 0st),0.98
1728,28,AC Parore (NZ),1992-2002,179,178,141,116,25,111,5,5 (3ct 2st),0.792
1729,29,Sarfaraz Ahmed (PAK),2007-2019,116,114,140,116,24,116,0,6 (6ct 0st),1.228
1730,30,SR Tendulkar (INDIA),1989-2012,463,456,140,140,0,0,140,4 (4ct 0st),0.307
1731,31,LRPL Taylor (NZ),2006-2019,228,224,137,137,0,0,137,4 (4ct 0st),0.611
1732,32,Younis Khan (PAK),2000-2015,265,260,135,135,0,5,130,4 (4ct 0st),0.519
1733,33,SP Fleming (ICC/NZ),1994-2007,280,276,133,133,0,0,133,4 (4ct 0st),0.481
1734,34,JH Kallis (Afr/ICC/SA),1996-2014,328,324,131,131,0,0,131,3 (3ct 0st),0.4039999999999999
1735,35,M Muralitharan (Asia/ICC/SL),1993-2011,350,347,130,130,0,0,130,3 (3ct 0st),0.374
1736,36,AR Border (AUS),1979-1994,273,270,127,127,0,0,127,3 (3ct 0st),0.47
1737,37,Shahid Afridi (Asia/ICC/PAK),1996-2015,398,392,127,127,0,0,127,2 (2ct 0st),0.3229999999999999
1738,38,Khaled Mashud (BDESH),1995-2006,126,126,126,91,35,91,0,5 (3ct 2st),1.0
1739,39,TM Dilshan (SL),1999-2016,330,325,124,123,1,5,118,3 (3ct 0st),0.381
1740,40,CH Gayle (ICC/WI),1999-2019,301,294,124,124,0,0,124,3 (3ct 0st),0.421
1741,41,V Kohli (INDIA),2008-2019,242,240,124,124,0,0,124,3 (3ct 0st),0.516
1742,42,RW Marsh (AUS),1971-1984,92,92,124,120,4,120,0,5 (5ct 0st),1.347
1743,43,ST Jayasuriya (Asia/SL),1989-2011,445,441,123,123,0,0,123,3 (3ct 0st),0.278
1744,44,CL Hooper (WI),1987-2003,227,225,120,120,0,0,120,4 (4ct 0st),0.5329999999999999
1745,45,BC Lara (ICC/WI),1990-2007,299,296,120,120,0,0,120,3 (3ct 0st),0.405
1746,46,L Ronchi (AUS/NZ),2008-2017,85,83,117,105,12,105,0,4 (4ct 0st),1.409
1747,47,MS Wade (AUS),2012-2017,94,94,117,108,9,108,0,5 (5ct 0st),1.244
1748,48,Inzamam-ul-Haq (Asia/PAK),1991-2007,378,373,113,113,0,0,113,3 (3ct 0st),0.302
1749,49,SR Waugh (AUS),1986-2002,325,324,111,111,0,0,111,3 (3ct 0st),0.342
1750,0,KC Sangakkara (Asia/ICC/SL),2000-2015,404,397,501,402,99,383,19,5 (4ct 1st),1.261
1751,1,AC Gilchrist (AUS/ICC),1996-2008,287,286,472,417,55,417,0,6 (6ct 0st),1.65
1752,2,MS Dhoni (Asia/INDIA),2004-2019,350,345,444,321,123,321,0,6 (5ct 1st),1.286
1753,3,MV Boucher (Afr/SA),1998-2011,295,291,425,403,22,402,1,6 (6ct 0st),1.46
1754,4,Moin Khan (PAK),1990-2004,219,217,287,214,73,214,0,5 (5ct 0st),1.3219999999999998
1755,5,BB McCullum (NZ),2002-2016,260,257,277,262,15,227,35,5 (5ct 0st),1.077
1756,6,IA Healy (AUS),1988-1997,168,168,233,194,39,194,0,4 (4ct 0st),1.386
1757,7,Mushfiqur Rahim (BDESH),2006-2019,216,215,225,181,44,179,2,5 (5ct 0st),1.046
1758,8,Rashid Latif (PAK),1992-2003,166,164,220,182,38,182,0,5 (5ct 0st),1.341
1759,9,DPMD Jayawardene (Asia/SL),1998-2015,448,443,218,218,0,0,218,4 (4ct 0st),0.492
1760,10,R Dravid (Asia/ICC/INDIA),1996-2011,344,341,210,196,14,72,124,4 (4ct 0st),0.615
1761,11,RS Kaluwitharana (SL),1990-2004,189,188,207,132,75,131,1,5 (4ct 1st),1.101
1762,12,PJL Dujon (WI),1981-1991,169,168,204,183,21,183,0,4 (4ct 0st),1.214
1763,13,JC Buttler (ENG),2012-2019,142,138,202,171,31,171,0,6 (6ct 0st),1.463
1764,14,RD Jacobs (WI),1996-2004,147,145,189,160,29,160,0,6 (5ct 1st),1.3030000000000002
1765,15,Kamran Akmal (PAK),2002-2017,157,154,188,157,31,156,1,5 (4ct 1st),1.22
1766,16,D Ramdin (WI),2005-2016,139,137,188,181,7,181,0,5 (5ct 0st),1.372
1767,17,AB de Villiers (Afr/SA),2005-2018,228,223,181,176,5,93,83,5 (5ct 0st),0.8109999999999999
1768,18,BJ Haddin (AUS),2001-2015,126,124,181,170,11,170,0,5 (5ct 0st),1.459
1769,19,AJ Stewart (ENG),1989-2003,170,169,174,159,15,148,11,6 (6ct 0st),1.029
1770,20,A Flower (ZIM),1992-2003,213,212,173,141,32,133,8,5 (5ct 0st),0.816
1771,21,Q de Kock (SA),2013-2019,115,111,166,158,8,158,0,6 (5ct 1st),1.495
1772,22,DJ Richardson (SA),1991-1998,122,121,165,148,17,148,0,5 (5ct 0st),1.3630000000000002
1773,23,RT Ponting (AUS/ICC),1995-2012,375,372,160,160,0,0,160,3 (3ct 0st),0.43
1774,24,M Azharuddin (INDIA),1985-2000,334,332,156,156,0,0,156,4 (4ct 0st),0.469
1775,25,NR Mongia (INDIA),1994-2000,140,139,154,110,44,110,0,5 (4ct 1st),1.107
1776,26,BRM Taylor (ZIM),2004-2019,193,193,154,125,29,96,29,5 (5ct 0st),0.797
1777,27,T Taibu (Afr/ZIM),2001-2012,150,150,147,114,33,112,2,4 (4ct 0st),0.98
1778,28,AC Parore (NZ),1992-2002,179,178,141,116,25,111,5,5 (3ct 2st),0.792
1779,29,Sarfaraz Ahmed (PAK),2007-2019,116,114,140,116,24,116,0,6 (6ct 0st),1.228
1780,30,SR Tendulkar (INDIA),1989-2012,463,456,140,140,0,0,140,4 (4ct 0st),0.307
1781,31,LRPL Taylor (NZ),2006-2019,228,224,137,137,0,0,137,4 (4ct 0st),0.611
1782,32,Younis Khan (PAK),2000-2015,265,260,135,135,0,5,130,4 (4ct 0st),0.519
1783,33,SP Fleming (ICC/NZ),1994-2007,280,276,133,133,0,0,133,4 (4ct 0st),0.481
1784,34,JH Kallis (Afr/ICC/SA),1996-2014,328,324,131,131,0,0,131,3 (3ct 0st),0.4039999999999999
1785,35,M Muralitharan (Asia/ICC/SL),1993-2011,350,347,130,130,0,0,130,3 (3ct 0st),0.374
1786,36,AR Border (AUS),1979-1994,273,270,127,127,0,0,127,3 (3ct 0st),0.47
1787,37,Shahid Afridi (Asia/ICC/PAK),1996-2015,398,392,127,127,0,0,127,2 (2ct 0st),0.3229999999999999
1788,38,Khaled Mashud (BDESH),1995-2006,126,126,126,91,35,91,0,5 (3ct 2st),1.0
1789,39,TM Dilshan (SL),1999-2016,330,325,124,123,1,5,118,3 (3ct 0st),0.381
1790,40,CH Gayle (ICC/WI),1999-2019,301,294,124,124,0,0,124,3 (3ct 0st),0.421
1791,41,V Kohli (INDIA),2008-2019,242,240,124,124,0,0,124,3 (3ct 0st),0.516
1792,42,RW Marsh (AUS),1971-1984,92,92,124,120,4,120,0,5 (5ct 0st),1.347
1793,43,ST Jayasuriya (Asia/SL),1989-2011,445,441,123,123,0,0,123,3 (3ct 0st),0.278
1794,44,CL Hooper (WI),1987-2003,227,225,120,120,0,0,120,4 (4ct 0st),0.5329999999999999
1795,45,BC Lara (ICC/WI),1990-2007,299,296,120,120,0,0,120,3 (3ct 0st),0.405
1796,46,L Ronchi (AUS/NZ),2008-2017,85,83,117,105,12,105,0,4 (4ct 0st),1.409
1797,47,MS Wade (AUS),2012-2017,94,94,117,108,9,108,0,5 (5ct 0st),1.244
1798,48,Inzamam-ul-Haq (Asia/PAK),1991-2007,378,373,113,113,0,0,113,3 (3ct 0st),0.302
1799,49,SR Waugh (AUS),1986-2002,325,324,111,111,0,0,111,3 (3ct 0st),0.342
1800,0,KC Sangakkara (Asia/ICC/SL),2000-2015,404,397,501,402,99,383,19,5 (4ct 1st),1.261
1801,1,AC Gilchrist (AUS/ICC),1996-2008,287,286,472,417,55,417,0,6 (6ct 0st),1.65
1802,2,MS Dhoni (Asia/INDIA),2004-2019,350,345,444,321,123,321,0,6 (5ct 1st),1.286
1803,3,MV Boucher (Afr/SA),1998-2011,295,291,425,403,22,402,1,6 (6ct 0st),1.46
1804,4,Moin Khan (PAK),1990-2004,219,217,287,214,73,214,0,5 (5ct 0st),1.3219999999999998
1805,5,BB McCullum (NZ),2002-2016,260,257,277,262,15,227,35,5 (5ct 0st),1.077
1806,6,IA Healy (AUS),1988-1997,168,168,233,194,39,194,0,4 (4ct 0st),1.386
1807,7,Mushfiqur Rahim (BDESH),2006-2019,216,215,225,181,44,179,2,5 (5ct 0st),1.046
1808,8,Rashid Latif (PAK),1992-2003,166,164,220,182,38,182,0,5 (5ct 0st),1.341
1809,9,DPMD Jayawardene (Asia/SL),1998-2015,448,443,218,218,0,0,218,4 (4ct 0st),0.492
1810,10,R Dravid (Asia/ICC/INDIA),1996-2011,344,341,210,196,14,72,124,4 (4ct 0st),0.615
1811,11,RS Kaluwitharana (SL),1990-2004,189,188,207,132,75,131,1,5 (4ct 1st),1.101
1812,12,PJL Dujon (WI),1981-1991,169,168,204,183,21,183,0,4 (4ct 0st),1.214
1813,13,JC Buttler (ENG),2012-2019,142,138,202,171,31,171,0,6 (6ct 0st),1.463
1814,14,RD Jacobs (WI),1996-2004,147,145,189,160,29,160,0,6 (5ct 1st),1.3030000000000002
1815,15,Kamran Akmal (PAK),2002-2017,157,154,188,157,31,156,1,5 (4ct 1st),1.22
1816,16,D Ramdin (WI),2005-2016,139,137,188,181,7,181,0,5 (5ct 0st),1.372
1817,17,AB de Villiers (Afr/SA),2005-2018,228,223,181,176,5,93,83,5 (5ct 0st),0.8109999999999999
1818,18,BJ Haddin (AUS),2001-2015,126,124,181,170,11,170,0,5 (5ct 0st),1.459
1819,19,AJ Stewart (ENG),1989-2003,170,169,174,159,15,148,11,6 (6ct 0st),1.029
1820,20,A Flower (ZIM),1992-2003,213,212,173,141,32,133,8,5 (5ct 0st),0.816
1821,21,Q de Kock (SA),2013-2019,115,111,166,158,8,158,0,6 (5ct 1st),1.495
1822,22,DJ Richardson (SA),1991-1998,122,121,165,148,17,148,0,5 (5ct 0st),1.3630000000000002
1823,23,RT Ponting (AUS/ICC),1995-2012,375,372,160,160,0,0,160,3 (3ct 0st),0.43
1824,24,M Azharuddin (INDIA),1985-2000,334,332,156,156,0,0,156,4 (4ct 0st),0.469
1825,25,NR Mongia (INDIA),1994-2000,140,139,154,110,44,110,0,5 (4ct 1st),1.107
1826,26,BRM Taylor (ZIM),2004-2019,193,193,154,125,29,96,29,5 (5ct 0st),0.797
1827,27,T Taibu (Afr/ZIM),2001-2012,150,150,147,114,33,112,2,4 (4ct 0st),0.98
1828,28,AC Parore (NZ),1992-2002,179,178,141,116,25,111,5,5 (3ct 2st),0.792
1829,29,Sarfaraz Ahmed (PAK),2007-2019,116,114,140,116,24,116,0,6 (6ct 0st),1.228
1830,30,SR Tendulkar (INDIA),1989-2012,463,456,140,140,0,0,140,4 (4ct 0st),0.307
1831,31,LRPL Taylor (NZ),2006-2019,228,224,137,137,0,0,137,4 (4ct 0st),0.611
1832,32,Younis Khan (PAK),2000-2015,265,260,135,135,0,5,130,4 (4ct 0st),0.519
1833,33,SP Fleming (ICC/NZ),1994-2007,280,276,133,133,0,0,133,4 (4ct 0st),0.481
1834,34,JH Kallis (Afr/ICC/SA),1996-2014,328,324,131,131,0,0,131,3 (3ct 0st),0.4039999999999999
1835,35,M Muralitharan (Asia/ICC/SL),1993-2011,350,347,130,130,0,0,130,3 (3ct 0st),0.374
1836,36,AR Border (AUS),1979-1994,273,270,127,127,0,0,127,3 (3ct 0st),0.47
1837,37,Shahid Afridi (Asia/ICC/PAK),1996-2015,398,392,127,127,0,0,127,2 (2ct 0st),0.3229999999999999
1838,38,Khaled Mashud (BDESH),1995-2006,126,126,126,91,35,91,0,5 (3ct 2st),1.0
1839,39,TM Dilshan (SL),1999-2016,330,325,124,123,1,5,118,3 (3ct 0st),0.381
1840,40,CH Gayle (ICC/WI),1999-2019,301,294,124,124,0,0,124,3 (3ct 0st),0.421
1841,41,V Kohli (INDIA),2008-2019,242,240,124,124,0,0,124,3 (3ct 0st),0.516
1842,42,RW Marsh (AUS),1971-1984,92,92,124,120,4,120,0,5 (5ct 0st),1.347
1843,43,ST Jayasuriya (Asia/SL),1989-2011,445,441,123,123,0,0,123,3 (3ct 0st),0.278
1844,44,CL Hooper (WI),1987-2003,227,225,120,120,0,0,120,4 (4ct 0st),0.5329999999999999
1845,45,BC Lara (ICC/WI),1990-2007,299,296,120,120,0,0,120,3 (3ct 0st),0.405
1846,46,L Ronchi (AUS/NZ),2008-2017,85,83,117,105,12,105,0,4 (4ct 0st),1.409
1847,47,MS Wade (AUS),2012-2017,94,94,117,108,9,108,0,5 (5ct 0st),1.244
1848,48,Inzamam-ul-Haq (Asia/PAK),1991-2007,378,373,113,113,0,0,113,3 (3ct 0st),0.302
1849,49,SR Waugh (AUS),1986-2002,325,324,111,111,0,0,111,3 (3ct 0st),0.342
1850,0,KC Sangakkara (Asia/ICC/SL),2000-2015,404,397,501,402,99,383,19,5 (4ct 1st),1.261
1851,1,AC Gilchrist (AUS/ICC),1996-2008,287,286,472,417,55,417,0,6 (6ct 0st),1.65
1852,2,MS Dhoni (Asia/INDIA),2004-2019,350,345,444,321,123,321,0,6 (5ct 1st),1.286
1853,3,MV Boucher (Afr/SA),1998-2011,295,291,425,403,22,402,1,6 (6ct 0st),1.46
1854,4,Moin Khan (PAK),1990-2004,219,217,287,214,73,214,0,5 (5ct 0st),1.3219999999999998
1855,5,BB McCullum (NZ),2002-2016,260,257,277,262,15,227,35,5 (5ct 0st),1.077
1856,6,IA Healy (AUS),1988-1997,168,168,233,194,39,194,0,4 (4ct 0st),1.386
1857,7,Mushfiqur Rahim (BDESH),2006-2019,216,215,225,181,44,179,2,5 (5ct 0st),1.046
1858,8,Rashid Latif (PAK),1992-2003,166,164,220,182,38,182,0,5 (5ct 0st),1.341
1859,9,DPMD Jayawardene (Asia/SL),1998-2015,448,443,218,218,0,0,218,4 (4ct 0st),0.492
1860,10,R Dravid (Asia/ICC/INDIA),1996-2011,344,341,210,196,14,72,124,4 (4ct 0st),0.615
1861,11,RS Kaluwitharana (SL),1990-2004,189,188,207,132,75,131,1,5 (4ct 1st),1.101
1862,12,PJL Dujon (WI),1981-1991,169,168,204,183,21,183,0,4 (4ct 0st),1.214
1863,13,JC Buttler (ENG),2012-2019,142,138,202,171,31,171,0,6 (6ct 0st),1.463
1864,14,RD Jacobs (WI),1996-2004,147,145,189,160,29,160,0,6 (5ct 1st),1.3030000000000002
1865,15,Kamran Akmal (PAK),2002-2017,157,154,188,157,31,156,1,5 (4ct 1st),1.22
1866,16,D Ramdin (WI),2005-2016,139,137,188,181,7,181,0,5 (5ct 0st),1.372
1867,17,AB de Villiers (Afr/SA),2005-2018,228,223,181,176,5,93,83,5 (5ct 0st),0.8109999999999999
1868,18,BJ Haddin (AUS),2001-2015,126,124,181,170,11,170,0,5 (5ct 0st),1.459
1869,19,AJ Stewart (ENG),1989-2003,170,169,174,159,15,148,11,6 (6ct 0st),1.029
1870,20,A Flower (ZIM),1992-2003,213,212,173,141,32,133,8,5 (5ct 0st),0.816
1871,21,Q de Kock (SA),2013-2019,115,111,166,158,8,158,0,6 (5ct 1st),1.495
1872,22,DJ Richardson (SA),1991-1998,122,121,165,148,17,148,0,5 (5ct 0st),1.3630000000000002
1873,23,RT Ponting (AUS/ICC),1995-2012,375,372,160,160,0,0,160,3 (3ct 0st),0.43
1874,24,M Azharuddin (INDIA),1985-2000,334,332,156,156,0,0,156,4 (4ct 0st),0.469
1875,25,NR Mongia (INDIA),1994-2000,140,139,154,110,44,110,0,5 (4ct 1st),1.107
1876,26,BRM Taylor (ZIM),2004-2019,193,193,154,125,29,96,29,5 (5ct 0st),0.797
1877,27,T Taibu (Afr/ZIM),2001-2012,150,150,147,114,33,112,2,4 (4ct 0st),0.98
1878,28,AC Parore (NZ),1992-2002,179,178,141,116,25,111,5,5 (3ct 2st),0.792
1879,29,Sarfaraz Ahmed (PAK),2007-2019,116,114,140,116,24,116,0,6 (6ct 0st),1.228
1880,30,SR Tendulkar (INDIA),1989-2012,463,456,140,140,0,0,140,4 (4ct 0st),0.307
1881,31,LRPL Taylor (NZ),2006-2019,228,224,137,137,0,0,137,4 (4ct 0st),0.611
1882,32,Younis Khan (PAK),2000-2015,265,260,135,135,0,5,130,4 (4ct 0st),0.519
1883,33,SP Fleming (ICC/NZ),1994-2007,280,276,133,133,0,0,133,4 (4ct 0st),0.481
1884,34,JH Kallis (Afr/ICC/SA),1996-2014,328,324,131,131,0,0,131,3 (3ct 0st),0.4039999999999999
1885,35,M Muralitharan (Asia/ICC/SL),1993-2011,350,347,130,130,0,0,130,3 (3ct 0st),0.374
1886,36,AR Border (AUS),1979-1994,273,270,127,127,0,0,127,3 (3ct 0st),0.47
1887,37,Shahid Afridi (Asia/ICC/PAK),1996-2015,398,392,127,127,0,0,127,2 (2ct 0st),0.3229999999999999
1888,38,Khaled Mashud (BDESH),1995-2006,126,126,126,91,35,91,0,5 (3ct 2st),1.0
1889,39,TM Dilshan (SL),1999-2016,330,325,124,123,1,5,118,3 (3ct 0st),0.381
1890,40,CH Gayle (ICC/WI),1999-2019,301,294,124,124,0,0,124,3 (3ct 0st),0.421
1891,41,V Kohli (INDIA),2008-2019,242,240,124,124,0,0,124,3 (3ct 0st),0.516
1892,42,RW Marsh (AUS),1971-1984,92,92,124,120,4,120,0,5 (5ct 0st),1.347
1893,43,ST Jayasuriya (Asia/SL),1989-2011,445,441,123,123,0,0,123,3 (3ct 0st),0.278
1894,44,CL Hooper (WI),1987-2003,227,225,120,120,0,0,120,4 (4ct 0st),0.5329999999999999
1895,45,BC Lara (ICC/WI),1990-2007,299,296,120,120,0,0,120,3 (3ct 0st),0.405
1896,46,L Ronchi (AUS/NZ),2008-2017,85,83,117,105,12,105,0,4 (4ct 0st),1.409
1897,47,MS Wade (AUS),2012-2017,94,94,117,108,9,108,0,5 (5ct 0st),1.244
1898,48,Inzamam-ul-Haq (Asia/PAK),1991-2007,378,373,113,113,0,0,113,3 (3ct 0st),0.302
1899,49,SR Waugh (AUS),1986-2002,325,324,111,111,0,0,111,3 (3ct 0st),0.342
1900,0,KC Sangakkara (Asia/ICC/SL),2000-2015,404,397,501,402,99,383,19,5 (4ct 1st),1.261
1901,1,AC Gilchrist (AUS/ICC),1996-2008,287,286,472,417,55,417,0,6 (6ct 0st),1.65
1902,2,MS Dhoni (Asia/INDIA),2004-2019,350,345,444,321,123,321,0,6 (5ct 1st),1.286
1903,3,MV Boucher (Afr/SA),1998-2011,295,291,425,403,22,402,1,6 (6ct 0st),1.46
1904,4,Moin Khan (PAK),1990-2004,219,217,287,214,73,214,0,5 (5ct 0st),1.3219999999999998
1905,5,BB McCullum (NZ),2002-2016,260,257,277,262,15,227,35,5 (5ct 0st),1.077
1906,6,IA Healy (AUS),1988-1997,168,168,233,194,39,194,0,4 (4ct 0st),1.386
1907,7,Mushfiqur Rahim (BDESH),2006-2019,216,215,225,181,44,179,2,5 (5ct 0st),1.046
1908,8,Rashid Latif (PAK),1992-2003,166,164,220,182,38,182,0,5 (5ct 0st),1.341
1909,9,DPMD Jayawardene (Asia/SL),1998-2015,448,443,218,218,0,0,218,4 (4ct 0st),0.492
1910,10,R Dravid (Asia/ICC/INDIA),1996-2011,344,341,210,196,14,72,124,4 (4ct 0st),0.615
1911,11,RS Kaluwitharana (SL),1990-2004,189,188,207,132,75,131,1,5 (4ct 1st),1.101
1912,12,PJL Dujon (WI),1981-1991,169,168,204,183,21,183,0,4 (4ct 0st),1.214
1913,13,JC Buttler (ENG),2012-2019,142,138,202,171,31,171,0,6 (6ct 0st),1.463
1914,14,RD Jacobs (WI),1996-2004,147,145,189,160,29,160,0,6 (5ct 1st),1.3030000000000002
1915,15,Kamran Akmal (PAK),2002-2017,157,154,188,157,31,156,1,5 (4ct 1st),1.22
1916,16,D Ramdin (WI),2005-2016,139,137,188,181,7,181,0,5 (5ct 0st),1.372
1917,17,AB de Villiers (Afr/SA),2005-2018,228,223,181,176,5,93,83,5 (5ct 0st),0.8109999999999999
1918,18,BJ Haddin (AUS),2001-2015,126,124,181,170,11,170,0,5 (5ct 0st),1.459
1919,19,AJ Stewart (ENG),1989-2003,170,169,174,159,15,148,11,6 (6ct 0st),1.029
1920,20,A Flower (ZIM),1992-2003,213,212,173,141,32,133,8,5 (5ct 0st),0.816
1921,21,Q de Kock (SA),2013-2019,115,111,166,158,8,158,0,6 (5ct 1st),1.495
1922,22,DJ Richardson (SA),1991-1998,122,121,165,148,17,148,0,5 (5ct 0st),1.3630000000000002
1923,23,RT Ponting (AUS/ICC),1995-2012,375,372,160,160,0,0,160,3 (3ct 0st),0.43
1924,24,M Azharuddin (INDIA),1985-2000,334,332,156,156,0,0,156,4 (4ct 0st),0.469
1925,25,NR Mongia (INDIA),1994-2000,140,139,154,110,44,110,0,5 (4ct 1st),1.107
1926,26,BRM Taylor (ZIM),2004-2019,193,193,154,125,29,96,29,5 (5ct 0st),0.797
1927,27,T Taibu (Afr/ZIM),2001-2012,150,150,147,114,33,112,2,4 (4ct 0st),0.98
1928,28,AC Parore (NZ),1992-2002,179,178,141,116,25,111,5,5 (3ct 2st),0.792
1929,29,Sarfaraz Ahmed (PAK),2007-2019,116,114,140,116,24,116,0,6 (6ct 0st),1.228
1930,30,SR Tendulkar (INDIA),1989-2012,463,456,140,140,0,0,140,4 (4ct 0st),0.307
1931,31,LRPL Taylor (NZ),2006-2019,228,224,137,137,0,0,137,4 (4ct 0st),0.611
1932,32,Younis Khan (PAK),2000-2015,265,260,135,135,0,5,130,4 (4ct 0st),0.519
1933,33,SP Fleming (ICC/NZ),1994-2007,280,276,133,133,0,0,133,4 (4ct 0st),0.481
1934,34,JH Kallis (Afr/ICC/SA),1996-2014,328,324,131,131,0,0,131,3 (3ct 0st),0.4039999999999999
1935,35,M Muralitharan (Asia/ICC/SL),1993-2011,350,347,130,130,0,0,130,3 (3ct 0st),0.374
1936,36,AR Border (AUS),1979-1994,273,270,127,127,0,0,127,3 (3ct 0st),0.47
1937,37,Shahid Afridi (Asia/ICC/PAK),1996-2015,398,392,127,127,0,0,127,2 (2ct 0st),0.3229999999999999
1938,38,Khaled Mashud (BDESH),1995-2006,126,126,126,91,35,91,0,5 (3ct 2st),1.0
1939,39,TM Dilshan (SL),1999-2016,330,325,124,123,1,5,118,3 (3ct 0st),0.381
1940,40,CH Gayle (ICC/WI),1999-2019,301,294,124,124,0,0,124,3 (3ct 0st),0.421
1941,41,V Kohli (INDIA),2008-2019,242,240,124,124,0,0,124,3 (3ct 0st),0.516
1942,42,RW Marsh (AUS),1971-1984,92,92,124,120,4,120,0,5 (5ct 0st),1.347
1943,43,ST Jayasuriya (Asia/SL),1989-2011,445,441,123,123,0,0,123,3 (3ct 0st),0.278
1944,44,CL Hooper (WI),1987-2003,227,225,120,120,0,0,120,4 (4ct 0st),0.5329999999999999
1945,45,BC Lara (ICC/WI),1990-2007,299,296,120,120,0,0,120,3 (3ct 0st),0.405
1946,46,L Ronchi (AUS/NZ),2008-2017,85,83,117,105,12,105,0,4 (4ct 0st),1.409
1947,47,MS Wade (AUS),2012-2017,94,94,117,108,9,108,0,5 (5ct 0st),1.244
1948,48,Inzamam-ul-Haq (Asia/PAK),1991-2007,378,373,113,113,0,0,113,3 (3ct 0st),0.302
1949,49,SR Waugh (AUS),1986-2002,325,324,111,111,0,0,111,3 (3ct 0st),0.342
1950,0,KC Sangakkara (Asia/ICC/SL),2000-2015,404,397,501,402,99,383,19,5 (4ct 1st),1.261
1951,1,AC Gilchrist (AUS/ICC),1996-2008,287,286,472,417,55,417,0,6 (6ct 0st),1.65
1952,2,MS Dhoni (Asia/INDIA),2004-2019,350,345,444,321,123,321,0,6 (5ct 1st),1.286
1953,3,MV Boucher (Afr/SA),1998-2011,295,291,425,403,22,402,1,6 (6ct 0st),1.46
1954,4,Moin Khan (PAK),1990-2004,219,217,287,214,73,214,0,5 (5ct 0st),1.3219999999999998
1955,5,BB McCullum (NZ),2002-2016,260,257,277,262,15,227,35,5 (5ct 0st),1.077
1956,6,IA Healy (AUS),1988-1997,168,168,233,194,39,194,0,4 (4ct 0st),1.386
1957,7,Mushfiqur Rahim (BDESH),2006-2019,216,215,225,181,44,179,2,5 (5ct 0st),1.046
1958,8,Rashid Latif (PAK),1992-2003,166,164,220,182,38,182,0,5 (5ct 0st),1.341
1959,9,DPMD Jayawardene (Asia/SL),1998-2015,448,443,218,218,0,0,218,4 (4ct 0st),0.492
1960,10,R Dravid (Asia/ICC/INDIA),1996-2011,344,341,210,196,14,72,124,4 (4ct 0st),0.615
1961,11,RS Kaluwitharana (SL),1990-2004,189,188,207,132,75,131,1,5 (4ct 1st),1.101
1962,12,PJL Dujon (WI),1981-1991,169,168,204,183,21,183,0,4 (4ct 0st),1.214
1963,13,JC Buttler (ENG),2012-2019,142,138,202,171,31,171,0,6 (6ct 0st),1.463
1964,14,RD Jacobs (WI),1996-2004,147,145,189,160,29,160,0,6 (5ct 1st),1.3030000000000002
1965,15,Kamran Akmal (PAK),2002-2017,157,154,188,157,31,156,1,5 (4ct 1st),1.22
1966,16,D Ramdin (WI),2005-2016,139,137,188,181,7,181,0,5 (5ct 0st),1.372
1967,17,AB de Villiers (Afr/SA),2005-2018,228,223,181,176,5,93,83,5 (5ct 0st),0.8109999999999999
1968,18,BJ Haddin (AUS),2001-2015,126,124,181,170,11,170,0,5 (5ct 0st),1.459
1969,19,AJ Stewart (ENG),1989-2003,170,169,174,159,15,148,11,6 (6ct 0st),1.029
1970,20,A Flower (ZIM),1992-2003,213,212,173,141,32,133,8,5 (5ct 0st),0.816
1971,21,Q de Kock (SA),2013-2019,115,111,166,158,8,158,0,6 (5ct 1st),1.495
1972,22,DJ Richardson (SA),1991-1998,122,121,165,148,17,148,0,5 (5ct 0st),1.3630000000000002
1973,23,RT Ponting (AUS/ICC),1995-2012,375,372,160,160,0,0,160,3 (3ct 0st),0.43
1974,24,M Azharuddin (INDIA),1985-2000,334,332,156,156,0,0,156,4 (4ct 0st),0.469
1975,25,NR Mongia (INDIA),1994-2000,140,139,154,110,44,110,0,5 (4ct 1st),1.107
1976,26,BRM Taylor (ZIM),2004-2019,193,193,154,125,29,96,29,5 (5ct 0st),0.797
1977,27,T Taibu (Afr/ZIM),2001-2012,150,150,147,114,33,112,2,4 (4ct 0st),0.98
1978,28,AC Parore (NZ),1992-2002,179,178,141,116,25,111,5,5 (3ct 2st),0.792
1979,29,Sarfaraz Ahmed (PAK),2007-2019,116,114,140,116,24,116,0,6 (6ct 0st),1.228
1980,30,SR Tendulkar (INDIA),1989-2012,463,456,140,140,0,0,140,4 (4ct 0st),0.307
1981,31,LRPL Taylor (NZ),2006-2019,228,224,137,137,0,0,137,4 (4ct 0st),0.611
1982,32,Younis Khan (PAK),2000-2015,265,260,135,135,0,5,130,4 (4ct 0st),0.519
1983,33,SP Fleming (ICC/NZ),1994-2007,280,276,133,133,0,0,133,4 (4ct 0st),0.481
1984,34,JH Kallis (Afr/ICC/SA),1996-2014,328,324,131,131,0,0,131,3 (3ct 0st),0.4039999999999999
1985,35,M Muralitharan (Asia/ICC/SL),1993-2011,350,347,130,130,0,0,130,3 (3ct 0st),0.374
1986,36,AR Border (AUS),1979-1994,273,270,127,127,0,0,127,3 (3ct 0st),0.47
1987,37,Shahid Afridi (Asia/ICC/PAK),1996-2015,398,392,127,127,0,0,127,2 (2ct 0st),0.3229999999999999
1988,38,Khaled Mashud (BDESH),1995-2006,126,126,126,91,35,91,0,5 (3ct 2st),1.0
1989,39,TM Dilshan (SL),1999-2016,330,325,124,123,1,5,118,3 (3ct 0st),0.381
1990,40,CH Gayle (ICC/WI),1999-2019,301,294,124,124,0,0,124,3 (3ct 0st),0.421
1991,41,V Kohli (INDIA),2008-2019,242,240,124,124,0,0,124,3 (3ct 0st),0.516
1992,42,RW Marsh (AUS),1971-1984,92,92,124,120,4,120,0,5 (5ct 0st),1.347
1993,43,ST Jayasuriya (Asia/SL),1989-2011,445,441,123,123,0,0,123,3 (3ct 0st),0.278
1994,44,CL Hooper (WI),1987-2003,227,225,120,120,0,0,120,4 (4ct 0st),0.5329999999999999
1995,45,BC Lara (ICC/WI),1990-2007,299,296,120,120,0,0,120,3 (3ct 0st),0.405
1996,46,L Ronchi (AUS/NZ),2008-2017,85,83,117,105,12,105,0,4 (4ct 0st),1.409
1997,47,MS Wade (AUS),2012-2017,94,94,117,108,9,108,0,5 (5ct 0st),1.244
1998,48,Inzamam-ul-Haq (Asia/PAK),1991-2007,378,373,113,113,0,0,113,3 (3ct 0st),0.302
1999,49,SR Waugh (AUS),1986-2002,325,324,111,111,0,0,111,3 (3ct 0st),0.342
2000,0,KC Sangakkara (Asia/ICC/SL),2000-2015,404,397,501,402,99,383,19,5 (4ct 1st),1.261
2001,1,AC Gilchrist (AUS/ICC),1996-2008,287,286,472,417,55,417,0,6 (6ct 0st),1.65
2002,2,MS Dhoni (Asia/INDIA),2004-2019,350,345,444,321,123,321,0,6 (5ct 1st),1.286
2003,3,MV Boucher (Afr/SA),1998-2011,295,291,425,403,22,402,1,6 (6ct 0st),1.46
2004,4,Moin Khan (PAK),1990-2004,219,217,287,214,73,214,0,5 (5ct 0st),1.3219999999999998
2005,5,BB McCullum (NZ),2002-2016,260,257,277,262,15,227,35,5 (5ct 0st),1.077
2006,6,IA Healy (AUS),1988-1997,168,168,233,194,39,194,0,4 (4ct 0st),1.386
2007,7,Mushfiqur Rahim (BDESH),2006-2019,216,215,225,181,44,179,2,5 (5ct 0st),1.046
2008,8,Rashid Latif (PAK),1992-2003,166,164,220,182,38,182,0,5 (5ct 0st),1.341
2009,9,DPMD Jayawardene (Asia/SL),1998-2015,448,443,218,218,0,0,218,4 (4ct 0st),0.492
2010,10,R Dravid (Asia/ICC/INDIA),1996-2011,344,341,210,196,14,72,124,4 (4ct 0st),0.615
2011,11,RS Kaluwitharana (SL),1990-2004,189,188,207,132,75,131,1,5 (4ct 1st),1.101
2012,12,PJL Dujon (WI),1981-1991,169,168,204,183,21,183,0,4 (4ct 0st),1.214
2013,13,JC Buttler (ENG),2012-2019,142,138,202,171,31,171,0,6 (6ct 0st),1.463
2014,14,RD Jacobs (WI),1996-2004,147,145,189,160,29,160,0,6 (5ct 1st),1.3030000000000002
2015,15,Kamran Akmal (PAK),2002-2017,157,154,188,157,31,156,1,5 (4ct 1st),1.22
2016,16,D Ramdin (WI),2005-2016,139,137,188,181,7,181,0,5 (5ct 0st),1.372
2017,17,AB de Villiers (Afr/SA),2005-2018,228,223,181,176,5,93,83,5 (5ct 0st),0.8109999999999999
2018,18,BJ Haddin (AUS),2001-2015,126,124,181,170,11,170,0,5 (5ct 0st),1.459
2019,19,AJ Stewart (ENG),1989-2003,170,169,174,159,15,148,11,6 (6ct 0st),1.029
2020,20,A Flower (ZIM),1992-2003,213,212,173,141,32,133,8,5 (5ct 0st),0.816
2021,21,Q de Kock (SA),2013-2019,115,111,166,158,8,158,0,6 (5ct 1st),1.495
2022,22,DJ Richardson (SA),1991-1998,122,121,165,148,17,148,0,5 (5ct 0st),1.3630000000000002
2023,23,RT Ponting (AUS/ICC),1995-2012,375,372,160,160,0,0,160,3 (3ct 0st),0.43
2024,24,M Azharuddin (INDIA),1985-2000,334,332,156,156,0,0,156,4 (4ct 0st),0.469
2025,25,NR Mongia (INDIA),1994-2000,140,139,154,110,44,110,0,5 (4ct 1st),1.107
2026,26,BRM Taylor (ZIM),2004-2019,193,193,154,125,29,96,29,5 (5ct 0st),0.797
2027,27,T Taibu (Afr/ZIM),2001-2012,150,150,147,114,33,112,2,4 (4ct 0st),0.98
2028,28,AC Parore (NZ),1992-2002,179,178,141,116,25,111,5,5 (3ct 2st),0.792
2029,29,Sarfaraz Ahmed (PAK),2007-2019,116,114,140,116,24,116,0,6 (6ct 0st),1.228
2030,30,SR Tendulkar (INDIA),1989-2012,463,456,140,140,0,0,140,4 (4ct 0st),0.307
2031,31,LRPL Taylor (NZ),2006-2019,228,224,137,137,0,0,137,4 (4ct 0st),0.611
2032,32,Younis Khan (PAK),2000-2015,265,260,135,135,0,5,130,4 (4ct 0st),0.519
2033,33,SP Fleming (ICC/NZ),1994-2007,280,276,133,133,0,0,133,4 (4ct 0st),0.481
2034,34,JH Kallis (Afr/ICC/SA),1996-2014,328,324,131,131,0,0,131,3 (3ct 0st),0.4039999999999999
2035,35,M Muralitharan (Asia/ICC/SL),1993-2011,350,347,130,130,0,0,130,3 (3ct 0st),0.374
2036,36,AR Border (AUS),1979-1994,273,270,127,127,0,0,127,3 (3ct 0st),0.47
2037,37,Shahid Afridi (Asia/ICC/PAK),1996-2015,398,392,127,127,0,0,127,2 (2ct 0st),0.3229999999999999
2038,38,Khaled Mashud (BDESH),1995-2006,126,126,126,91,35,91,0,5 (3ct 2st),1.0
2039,39,TM Dilshan (SL),1999-2016,330,325,124,123,1,5,118,3 (3ct 0st),0.381
2040,40,CH Gayle (ICC/WI),1999-2019,301,294,124,124,0,0,124,3 (3ct 0st),0.421
2041,41,V Kohli (INDIA),2008-2019,242,240,124,124,0,0,124,3 (3ct 0st),0.516
2042,42,RW Marsh (AUS),1971-1984,92,92,124,120,4,120,0,5 (5ct 0st),1.347
2043,43,ST Jayasuriya (Asia/SL),1989-2011,445,441,123,123,0,0,123,3 (3ct 0st),0.278
2044,44,CL Hooper (WI),1987-2003,227,225,120,120,0,0,120,4 (4ct 0st),0.5329999999999999
2045,45,BC Lara (ICC/WI),1990-2007,299,296,120,120,0,0,120,3 (3ct 0st),0.405
2046,46,L Ronchi (AUS/NZ),2008-2017,85,83,117,105,12,105,0,4 (4ct 0st),1.409
2047,47,MS Wade (AUS),2012-2017,94,94,117,108,9,108,0,5 (5ct 0st),1.244
2048,48,Inzamam-ul-Haq (Asia/PAK),1991-2007,378,373,113,113,0,0,113,3 (3ct 0st),0.302
2049,49,SR Waugh (AUS),1986-2002,325,324,111,111,0,0,111,3 (3ct 0st),0.342
2050,0,KC Sangakkara (Asia/ICC/SL),2000-2015,404,397,501,402,99,383,19,5 (4ct 1st),1.261
2051,1,AC Gilchrist (AUS/ICC),1996-2008,287,286,472,417,55,417,0,6 (6ct 0st),1.65
2052,2,MS Dhoni (Asia/INDIA),2004-2019,350,345,444,321,123,321,0,6 (5ct 1st),1.286
2053,3,MV Boucher (Afr/SA),1998-2011,295,291,425,403,22,402,1,6 (6ct 0st),1.46
2054,4,Moin Khan (PAK),1990-2004,219,217,287,214,73,214,0,5 (5ct 0st),1.3219999999999998
2055,5,BB McCullum (NZ),2002-2016,260,257,277,262,15,227,35,5 (5ct 0st),1.077
2056,6,IA Healy (AUS),1988-1997,168,168,233,194,39,194,0,4 (4ct 0st),1.386
2057,7,Mushfiqur Rahim (BDESH),2006-2019,216,215,225,181,44,179,2,5 (5ct 0st),1.046
2058,8,Rashid Latif (PAK),1992-2003,166,164,220,182,38,182,0,5 (5ct 0st),1.341
2059,9,DPMD Jayawardene (Asia/SL),1998-2015,448,443,218,218,0,0,218,4 (4ct 0st),0.492
2060,10,R Dravid (Asia/ICC/INDIA),1996-2011,344,341,210,196,14,72,124,4 (4ct 0st),0.615
2061,11,RS Kaluwitharana (SL),1990-2004,189,188,207,132,75,131,1,5 (4ct 1st),1.101
2062,12,PJL Dujon (WI),1981-1991,169,168,204,183,21,183,0,4 (4ct 0st),1.214
2063,13,JC Buttler (ENG),2012-2019,142,138,202,171,31,171,0,6 (6ct 0st),1.463
2064,14,RD Jacobs (WI),1996-2004,147,145,189,160,29,160,0,6 (5ct 1st),1.3030000000000002
2065,15,Kamran Akmal (PAK),2002-2017,157,154,188,157,31,156,1,5 (4ct 1st),1.22
2066,16,D Ramdin (WI),2005-2016,139,137,188,181,7,181,0,5 (5ct 0st),1.372
2067,17,AB de Villiers (Afr/SA),2005-2018,228,223,181,176,5,93,83,5 (5ct 0st),0.8109999999999999
2068,18,BJ Haddin (AUS),2001-2015,126,124,181,170,11,170,0,5 (5ct 0st),1.459
2069,19,AJ Stewart (ENG),1989-2003,170,169,174,159,15,148,11,6 (6ct 0st),1.029
2070,20,A Flower (ZIM),1992-2003,213,212,173,141,32,133,8,5 (5ct 0st),0.816
2071,21,Q de Kock (SA),2013-2019,115,111,166,158,8,158,0,6 (5ct 1st),1.495
2072,22,DJ Richardson (SA),1991-1998,122,121,165,148,17,148,0,5 (5ct 0st),1.3630000000000002
2073,23,RT Ponting (AUS/ICC),1995-2012,375,372,160,160,0,0,160,3 (3ct 0st),0.43
2074,24,M Azharuddin (INDIA),1985-2000,334,332,156,156,0,0,156,4 (4ct 0st),0.469
2075,25,NR Mongia (INDIA),1994-2000,140,139,154,110,44,110,0,5 (4ct 1st),1.107
2076,26,BRM Taylor (ZIM),2004-2019,193,193,154,125,29,96,29,5 (5ct 0st),0.797
2077,27,T Taibu (Afr/ZIM),2001-2012,150,150,147,114,33,112,2,4 (4ct 0st),0.98
2078,28,AC Parore (NZ),1992-2002,179,178,141,116,25,111,5,5 (3ct 2st),0.792
2079,29,Sarfaraz Ahmed (PAK),2007-2019,116,114,140,116,24,116,0,6 (6ct 0st),1.228
2080,30,SR Tendulkar (INDIA),1989-2012,463,456,140,140,0,0,140,4 (4ct 0st),0.307
2081,31,LRPL Taylor (NZ),2006-2019,228,224,137,137,0,0,137,4 (4ct 0st),0.611
2082,32,Younis Khan (PAK),2000-2015,265,260,135,135,0,5,130,4 (4ct 0st),0.519
2083,33,SP Fleming (ICC/NZ),1994-2007,280,276,133,133,0,0,133,4 (4ct 0st),0.481
2084,34,JH Kallis (Afr/ICC/SA),1996-2014,328,324,131,131,0,0,131,3 (3ct 0st),0.4039999999999999
2085,35,M Muralitharan (Asia/ICC/SL),1993-2011,350,347,130,130,0,0,130,3 (3ct 0st),0.374
2086,36,AR Border (AUS),1979-1994,273,270,127,127,0,0,127,3 (3ct 0st),0.47
2087,37,Shahid Afridi (Asia/ICC/PAK),1996-2015,398,392,127,127,0,0,127,2 (2ct 0st),0.3229999999999999
2088,38,Khaled Mashud (BDESH),1995-2006,126,126,126,91,35,91,0,5 (3ct 2st),1.0
2089,39,TM Dilshan (SL),1999-2016,330,325,124,123,1,5,118,3 (3ct 0st),0.381
2090,40,CH Gayle (ICC/WI),1999-2019,301,294,124,124,0,0,124,3 (3ct 0st),0.421
2091,41,V Kohli (INDIA),2008-2019,242,240,124,124,0,0,124,3 (3ct 0st),0.516
2092,42,RW Marsh (AUS),1971-1984,92,92,124,120,4,120,0,5 (5ct 0st),1.347
2093,43,ST Jayasuriya (Asia/SL),1989-2011,445,441,123,123,0,0,123,3 (3ct 0st),0.278
2094,44,CL Hooper (WI),1987-2003,227,225,120,120,0,0,120,4 (4ct 0st),0.5329999999999999
2095,45,BC Lara (ICC/WI),1990-2007,299,296,120,120,0,0,120,3 (3ct 0st),0.405
2096,46,L Ronchi (AUS/NZ),2008-2017,85,83,117,105,12,105,0,4 (4ct 0st),1.409
2097,47,MS Wade (AUS),2012-2017,94,94,117,108,9,108,0,5 (5ct 0st),1.244
2098,48,Inzamam-ul-Haq (Asia/PAK),1991-2007,378,373,113,113,0,0,113,3 (3ct 0st),0.302
2099,49,SR Waugh (AUS),1986-2002,325,324,111,111,0,0,111,3 (3ct 0st),0.342
2100,0,KC Sangakkara (Asia/ICC/SL),2000-2015,404,397,501,402,99,383,19,5 (4ct 1st),1.261
2101,1,AC Gilchrist (AUS/ICC),1996-2008,287,286,472,417,55,417,0,6 (6ct 0st),1.65
2102,2,MS Dhoni (Asia/INDIA),2004-2019,350,345,444,321,123,321,0,6 (5ct 1st),1.286
2103,3,MV Boucher (Afr/SA),1998-2011,295,291,425,403,22,402,1,6 (6ct 0st),1.46
2104,4,Moin Khan (PAK),1990-2004,219,217,287,214,73,214,0,5 (5ct 0st),1.3219999999999998
2105,5,BB McCullum (NZ),2002-2016,260,257,277,262,15,227,35,5 (5ct 0st),1.077
2106,6,IA Healy (AUS),1988-1997,168,168,233,194,39,194,0,4 (4ct 0st),1.386
2107,7,Mushfiqur Rahim (BDESH),2006-2019,216,215,225,181,44,179,2,5 (5ct 0st),1.046
2108,8,Rashid Latif (PAK),1992-2003,166,164,220,182,38,182,0,5 (5ct 0st),1.341
2109,9,DPMD Jayawardene (Asia/SL),1998-2015,448,443,218,218,0,0,218,4 (4ct 0st),0.492
2110,10,R Dravid (Asia/ICC/INDIA),1996-2011,344,341,210,196,14,72,124,4 (4ct 0st),0.615
2111,11,RS Kaluwitharana (SL),1990-2004,189,188,207,132,75,131,1,5 (4ct 1st),1.101
2112,12,PJL Dujon (WI),1981-1991,169,168,204,183,21,183,0,4 (4ct 0st),1.214
2113,13,JC Buttler (ENG),2012-2019,142,138,202,171,31,171,0,6 (6ct 0st),1.463
2114,14,RD Jacobs (WI),1996-2004,147,145,189,160,29,160,0,6 (5ct 1st),1.3030000000000002
2115,15,Kamran Akmal (PAK),2002-2017,157,154,188,157,31,156,1,5 (4ct 1st),1.22
2116,16,D Ramdin (WI),2005-2016,139,137,188,181,7,181,0,5 (5ct 0st),1.372
2117,17,AB de Villiers (Afr/SA),2005-2018,228,223,181,176,5,93,83,5 (5ct 0st),0.8109999999999999
2118,18,BJ Haddin (AUS),2001-2015,126,124,181,170,11,170,0,5 (5ct 0st),1.459
2119,19,AJ Stewart (ENG),1989-2003,170,169,174,159,15,148,11,6 (6ct 0st),1.029
2120,20,A Flower (ZIM),1992-2003,213,212,173,141,32,133,8,5 (5ct 0st),0.816
2121,21,Q de Kock (SA),2013-2019,115,111,166,158,8,158,0,6 (5ct 1st),1.495
2122,22,DJ Richardson (SA),1991-1998,122,121,165,148,17,148,0,5 (5ct 0st),1.3630000000000002
2123,23,RT Ponting (AUS/ICC),1995-2012,375,372,160,160,0,0,160,3 (3ct 0st),0.43
2124,24,M Azharuddin (INDIA),1985-2000,334,332,156,156,0,0,156,4 (4ct 0st),0.469
2125,25,NR Mongia (INDIA),1994-2000,140,139,154,110,44,110,0,5 (4ct 1st),1.107
2126,26,BRM Taylor (ZIM),2004-2019,193,193,154,125,29,96,29,5 (5ct 0st),0.797
2127,27,T Taibu (Afr/ZIM),2001-2012,150,150,147,114,33,112,2,4 (4ct 0st),0.98
2128,28,AC Parore (NZ),1992-2002,179,178,141,116,25,111,5,5 (3ct 2st),0.792
2129,29,Sarfaraz Ahmed (PAK),2007-2019,116,114,140,116,24,116,0,6 (6ct 0st),1.228
2130,30,SR Tendulkar (INDIA),1989-2012,463,456,140,140,0,0,140,4 (4ct 0st),0.307
2131,31,LRPL Taylor (NZ),2006-2019,228,224,137,137,0,0,137,4 (4ct 0st),0.611
2132,32,Younis Khan (PAK),2000-2015,265,260,135,135,0,5,130,4 (4ct 0st),0.519
2133,33,SP Fleming (ICC/NZ),1994-2007,280,276,133,133,0,0,133,4 (4ct 0st),0.481
2134,34,JH Kallis (Afr/ICC/SA),1996-2014,328,324,131,131,0,0,131,3 (3ct 0st),0.4039999999999999
2135,35,M Muralitharan (Asia/ICC/SL),1993-2011,350,347,130,130,0,0,130,3 (3ct 0st),0.374
2136,36,AR Border (AUS),1979-1994,273,270,127,127,0,0,127,3 (3ct 0st),0.47
2137,37,Shahid Afridi (Asia/ICC/PAK),1996-2015,398,392,127,127,0,0,127,2 (2ct 0st),0.3229999999999999
2138,38,Khaled Mashud (BDESH),1995-2006,126,126,126,91,35,91,0,5 (3ct 2st),1.0
2139,39,TM Dilshan (SL),1999-2016,330,325,124,123,1,5,118,3 (3ct 0st),0.381
2140,40,CH Gayle (ICC/WI),1999-2019,301,294,124,124,0,0,124,3 (3ct 0st),0.421
2141,41,V Kohli (INDIA),2008-2019,242,240,124,124,0,0,124,3 (3ct 0st),0.516
2142,42,RW Marsh (AUS),1971-1984,92,92,124,120,4,120,0,5 (5ct 0st),1.347
2143,43,ST Jayasuriya (Asia/SL),1989-2011,445,441,123,123,0,0,123,3 (3ct 0st),0.278
2144,44,CL Hooper (WI),1987-2003,227,225,120,120,0,0,120,4 (4ct 0st),0.5329999999999999
2145,45,BC Lara (ICC/WI),1990-2007,299,296,120,120,0,0,120,3 (3ct 0st),0.405
2146,46,L Ronchi (AUS/NZ),2008-2017,85,83,117,105,12,105,0,4 (4ct 0st),1.409
2147,47,MS Wade (AUS),2012-2017,94,94,117,108,9,108,0,5 (5ct 0st),1.244
2148,48,Inzamam-ul-Haq (Asia/PAK),1991-2007,378,373,113,113,0,0,113,3 (3ct 0st),0.302
2149,49,SR Waugh (AUS),1986-2002,325,324,111,111,0,0,111,3 (3ct 0st),0.342
2150,0,KC Sangakkara (Asia/ICC/SL),2000-2015,404,397,501,402,99,383,19,5 (4ct 1st),1.261
2151,1,AC Gilchrist (AUS/ICC),1996-2008,287,286,472,417,55,417,0,6 (6ct 0st),1.65
2152,2,MS Dhoni (Asia/INDIA),2004-2019,350,345,444,321,123,321,0,6 (5ct 1st),1.286
2153,3,MV Boucher (Afr/SA),1998-2011,295,291,425,403,22,402,1,6 (6ct 0st),1.46
2154,4,Moin Khan (PAK),1990-2004,219,217,287,214,73,214,0,5 (5ct 0st),1.3219999999999998
2155,5,BB McCullum (NZ),2002-2016,260,257,277,262,15,227,35,5 (5ct 0st),1.077
2156,6,IA Healy (AUS),1988-1997,168,168,233,194,39,194,0,4 (4ct 0st),1.386
2157,7,Mushfiqur Rahim (BDESH),2006-2019,216,215,225,181,44,179,2,5 (5ct 0st),1.046
2158,8,Rashid Latif (PAK),1992-2003,166,164,220,182,38,182,0,5 (5ct 0st),1.341
2159,9,DPMD Jayawardene (Asia/SL),1998-2015,448,443,218,218,0,0,218,4 (4ct 0st),0.492
2160,10,R Dravid (Asia/ICC/INDIA),1996-2011,344,341,210,196,14,72,124,4 (4ct 0st),0.615
2161,11,RS Kaluwitharana (SL),1990-2004,189,188,207,132,75,131,1,5 (4ct 1st),1.101
2162,12,PJL Dujon (WI),1981-1991,169,168,204,183,21,183,0,4 (4ct 0st),1.214
2163,13,JC Buttler (ENG),2012-2019,142,138,202,171,31,171,0,6 (6ct 0st),1.463
2164,14,RD Jacobs (WI),1996-2004,147,145,189,160,29,160,0,6 (5ct 1st),1.3030000000000002
2165,15,Kamran Akmal (PAK),2002-2017,157,154,188,157,31,156,1,5 (4ct 1st),1.22
2166,16,D Ramdin (WI),2005-2016,139,137,188,181,7,181,0,5 (5ct 0st),1.372
2167,17,AB de Villiers (Afr/SA),2005-2018,228,223,181,176,5,93,83,5 (5ct 0st),0.8109999999999999
2168,18,BJ Haddin (AUS),2001-2015,126,124,181,170,11,170,0,5 (5ct 0st),1.459
2169,19,AJ Stewart (ENG),1989-2003,170,169,174,159,15,148,11,6 (6ct 0st),1.029
2170,20,A Flower (ZIM),1992-2003,213,212,173,141,32,133,8,5 (5ct 0st),0.816
2171,21,Q de Kock (SA),2013-2019,115,111,166,158,8,158,0,6 (5ct 1st),1.495
2172,22,DJ Richardson (SA),1991-1998,122,121,165,148,17,148,0,5 (5ct 0st),1.3630000000000002
2173,23,RT Ponting (AUS/ICC),1995-2012,375,372,160,160,0,0,160,3 (3ct 0st),0.43
2174,24,M Azharuddin (INDIA),1985-2000,334,332,156,156,0,0,156,4 (4ct 0st),0.469
2175,25,NR Mongia (INDIA),1994-2000,140,139,154,110,44,110,0,5 (4ct 1st),1.107
2176,26,BRM Taylor (ZIM),2004-2019,193,193,154,125,29,96,29,5 (5ct 0st),0.797
2177,27,T Taibu (Afr/ZIM),2001-2012,150,150,147,114,33,112,2,4 (4ct 0st),0.98
2178,28,AC Parore (NZ),1992-2002,179,178,141,116,25,111,5,5 (3ct 2st),0.792
2179,29,Sarfaraz Ahmed (PAK),2007-2019,116,114,140,116,24,116,0,6 (6ct 0st),1.228
2180,30,SR Tendulkar (INDIA),1989-2012,463,456,140,140,0,0,140,4 (4ct 0st),0.307
2181,31,LRPL Taylor (NZ),2006-2019,228,224,137,137,0,0,137,4 (4ct 0st),0.611
2182,32,Younis Khan (PAK),2000-2015,265,260,135,135,0,5,130,4 (4ct 0st),0.519
2183,33,SP Fleming (ICC/NZ),1994-2007,280,276,133,133,0,0,133,4 (4ct 0st),0.481
2184,34,JH Kallis (Afr/ICC/SA),1996-2014,328,324,131,131,0,0,131,3 (3ct 0st),0.4039999999999999
2185,35,M Muralitharan (Asia/ICC/SL),1993-2011,350,347,130,130,0,0,130,3 (3ct 0st),0.374
2186,36,AR Border (AUS),1979-1994,273,270,127,127,0,0,127,3 (3ct 0st),0.47
2187,37,Shahid Afridi (Asia/ICC/PAK),1996-2015,398,392,127,127,0,0,127,2 (2ct 0st),0.3229999999999999
2188,38,Khaled Mashud (BDESH),1995-2006,126,126,126,91,35,91,0,5 (3ct 2st),1.0
2189,39,TM Dilshan (SL),1999-2016,330,325,124,123,1,5,118,3 (3ct 0st),0.381
2190,40,CH Gayle (ICC/WI),1999-2019,301,294,124,124,0,0,124,3 (3ct 0st),0.421
2191,41,V Kohli (INDIA),2008-2019,242,240,124,124,0,0,124,3 (3ct 0st),0.516
2192,42,RW Marsh (AUS),1971-1984,92,92,124,120,4,120,0,5 (5ct 0st),1.347
2193,43,ST Jayasuriya (Asia/SL),1989-2011,445,441,123,123,0,0,123,3 (3ct 0st),0.278
2194,44,CL Hooper (WI),1987-2003,227,225,120,120,0,0,120,4 (4ct 0st),0.5329999999999999
2195,45,BC Lara (ICC/WI),1990-2007,299,296,120,120,0,0,120,3 (3ct 0st),0.405
2196,46,L Ronchi (AUS/NZ),2008-2017,85,83,117,105,12,105,0,4 (4ct 0st),1.409
2197,47,MS Wade (AUS),2012-2017,94,94,117,108,9,108,0,5 (5ct 0st),1.244
2198,48,Inzamam-ul-Haq (Asia/PAK),1991-2007,378,373,113,113,0,0,113,3 (3ct 0st),0.302
2199,49,SR Waugh (AUS),1986-2002,325,324,111,111,0,0,111,3 (3ct 0st),0.342
2200,0,KC Sangakkara (Asia/ICC/SL),2000-2015,404,397,501,402,99,383,19,5 (4ct 1st),1.261
2201,1,AC Gilchrist (AUS/ICC),1996-2008,287,286,472,417,55,417,0,6 (6ct 0st),1.65
2202,2,MS Dhoni (Asia/INDIA),2004-2019,350,345,444,321,123,321,0,6 (5ct 1st),1.286
2203,3,MV Boucher (Afr/SA),1998-2011,295,291,425,403,22,402,1,6 (6ct 0st),1.46
2204,4,Moin Khan (PAK),1990-2004,219,217,287,214,73,214,0,5 (5ct 0st),1.3219999999999998
2205,5,BB McCullum (NZ),2002-2016,260,257,277,262,15,227,35,5 (5ct 0st),1.077
2206,6,IA Healy (AUS),1988-1997,168,168,233,194,39,194,0,4 (4ct 0st),1.386
2207,7,Mushfiqur Rahim (BDESH),2006-2019,216,215,225,181,44,179,2,5 (5ct 0st),1.046
2208,8,Rashid Latif (PAK),1992-2003,166,164,220,182,38,182,0,5 (5ct 0st),1.341
2209,9,DPMD Jayawardene (Asia/SL),1998-2015,448,443,218,218,0,0,218,4 (4ct 0st),0.492
2210,10,R Dravid (Asia/ICC/INDIA),1996-2011,344,341,210,196,14,72,124,4 (4ct 0st),0.615
2211,11,RS Kaluwitharana (SL),1990-2004,189,188,207,132,75,131,1,5 (4ct 1st),1.101
2212,12,PJL Dujon (WI),1981-1991,169,168,204,183,21,183,0,4 (4ct 0st),1.214
2213,13,JC Buttler (ENG),2012-2019,142,138,202,171,31,171,0,6 (6ct 0st),1.463
2214,14,RD Jacobs (WI),1996-2004,147,145,189,160,29,160,0,6 (5ct 1st),1.3030000000000002
2215,15,Kamran Akmal (PAK),2002-2017,157,154,188,157,31,156,1,5 (4ct 1st),1.22
2216,16,D Ramdin (WI),2005-2016,139,137,188,181,7,181,0,5 (5ct 0st),1.372
2217,17,AB de Villiers (Afr/SA),2005-2018,228,223,181,176,5,93,83,5 (5ct 0st),0.8109999999999999
2218,18,BJ Haddin (AUS),2001-2015,126,124,181,170,11,170,0,5 (5ct 0st),1.459
2219,19,AJ Stewart (ENG),1989-2003,170,169,174,159,15,148,11,6 (6ct 0st),1.029
2220,20,A Flower (ZIM),1992-2003,213,212,173,141,32,133,8,5 (5ct 0st),0.816
2221,21,Q de Kock (SA),2013-2019,115,111,166,158,8,158,0,6 (5ct 1st),1.495
2222,22,DJ Richardson (SA),1991-1998,122,121,165,148,17,148,0,5 (5ct 0st),1.3630000000000002
2223,23,RT Ponting (AUS/ICC),1995-2012,375,372,160,160,0,0,160,3 (3ct 0st),0.43
2224,24,M Azharuddin (INDIA),1985-2000,334,332,156,156,0,0,156,4 (4ct 0st),0.469
2225,25,NR Mongia (INDIA),1994-2000,140,139,154,110,44,110,0,5 (4ct 1st),1.107
2226,26,BRM Taylor (ZIM),2004-2019,193,193,154,125,29,96,29,5 (5ct 0st),0.797
2227,27,T Taibu (Afr/ZIM),2001-2012,150,150,147,114,33,112,2,4 (4ct 0st),0.98
2228,28,AC Parore (NZ),1992-2002,179,178,141,116,25,111,5,5 (3ct 2st),0.792
2229,29,Sarfaraz Ahmed (PAK),2007-2019,116,114,140,116,24,116,0,6 (6ct 0st),1.228
2230,30,SR Tendulkar (INDIA),1989-2012,463,456,140,140,0,0,140,4 (4ct 0st),0.307
2231,31,LRPL Taylor (NZ),2006-2019,228,224,137,137,0,0,137,4 (4ct 0st),0.611
2232,32,Younis Khan (PAK),2000-2015,265,260,135,135,0,5,130,4 (4ct 0st),0.519
2233,33,SP Fleming (ICC/NZ),1994-2007,280,276,133,133,0,0,133,4 (4ct 0st),0.481
2234,34,JH Kallis (Afr/ICC/SA),1996-2014,328,324,131,131,0,0,131,3 (3ct 0st),0.4039999999999999
2235,35,M Muralitharan (Asia/ICC/SL),1993-2011,350,347,130,130,0,0,130,3 (3ct 0st),0.374
2236,36,AR Border (AUS),1979-1994,273,270,127,127,0,0,127,3 (3ct 0st),0.47
2237,37,Shahid Afridi (Asia/ICC/PAK),1996-2015,398,392,127,127,0,0,127,2 (2ct 0st),0.3229999999999999
2238,38,Khaled Mashud (BDESH),1995-2006,126,126,126,91,35,91,0,5 (3ct 2st),1.0
2239,39,TM Dilshan (SL),1999-2016,330,325,124,123,1,5,118,3 (3ct 0st),0.381
2240,40,CH Gayle (ICC/WI),1999-2019,301,294,124,124,0,0,124,3 (3ct 0st),0.421
2241,41,V Kohli (INDIA),2008-2019,242,240,124,124,0,0,124,3 (3ct 0st),0.516
2242,42,RW Marsh (AUS),1971-1984,92,92,124,120,4,120,0,5 (5ct 0st),1.347
2243,43,ST Jayasuriya (Asia/SL),1989-2011,445,441,123,123,0,0,123,3 (3ct 0st),0.278
2244,44,CL Hooper (WI),1987-2003,227,225,120,120,0,0,120,4 (4ct 0st),0.5329999999999999
2245,45,BC Lara (ICC/WI),1990-2007,299,296,120,120,0,0,120,3 (3ct 0st),0.405
2246,46,L Ronchi (AUS/NZ),2008-2017,85,83,117,105,12,105,0,4 (4ct 0st),1.409
2247,47,MS Wade (AUS),2012-2017,94,94,117,108,9,108,0,5 (5ct 0st),1.244
2248,48,Inzamam-ul-Haq (Asia/PAK),1991-2007,378,373,113,113,0,0,113,3 (3ct 0st),0.302
2249,49,SR Waugh (AUS),1986-2002,325,324,111,111,0,0,111,3 (3ct 0st),0.342
2250,0,KC Sangakkara (Asia/ICC/SL),2000-2015,404,397,501,402,99,383,19,5 (4ct 1st),1.261
2251,1,AC Gilchrist (AUS/ICC),1996-2008,287,286,472,417,55,417,0,6 (6ct 0st),1.65
2252,2,MS Dhoni (Asia/INDIA),2004-2019,350,345,444,321,123,321,0,6 (5ct 1st),1.286
2253,3,MV Boucher (Afr/SA),1998-2011,295,291,425,403,22,402,1,6 (6ct 0st),1.46
2254,4,Moin Khan (PAK),1990-2004,219,217,287,214,73,214,0,5 (5ct 0st),1.3219999999999998
2255,5,BB McCullum (NZ),2002-2016,260,257,277,262,15,227,35,5 (5ct 0st),1.077
2256,6,IA Healy (AUS),1988-1997,168,168,233,194,39,194,0,4 (4ct 0st),1.386
2257,7,Mushfiqur Rahim (BDESH),2006-2019,216,215,225,181,44,179,2,5 (5ct 0st),1.046
2258,8,Rashid Latif (PAK),1992-2003,166,164,220,182,38,182,0,5 (5ct 0st),1.341
2259,9,DPMD Jayawardene (Asia/SL),1998-2015,448,443,218,218,0,0,218,4 (4ct 0st),0.492
2260,10,R Dravid (Asia/ICC/INDIA),1996-2011,344,341,210,196,14,72,124,4 (4ct 0st),0.615
2261,11,RS Kaluwitharana (SL),1990-2004,189,188,207,132,75,131,1,5 (4ct 1st),1.101
2262,12,PJL Dujon (WI),1981-1991,169,168,204,183,21,183,0,4 (4ct 0st),1.214
2263,13,JC Buttler (ENG),2012-2019,142,138,202,171,31,171,0,6 (6ct 0st),1.463
2264,14,RD Jacobs (WI),1996-2004,147,145,189,160,29,160,0,6 (5ct 1st),1.3030000000000002
2265,15,Kamran Akmal (PAK),2002-2017,157,154,188,157,31,156,1,5 (4ct 1st),1.22
2266,16,D Ramdin (WI),2005-2016,139,137,188,181,7,181,0,5 (5ct 0st),1.372
2267,17,AB de Villiers (Afr/SA),2005-2018,228,223,181,176,5,93,83,5 (5ct 0st),0.8109999999999999
2268,18,BJ Haddin (AUS),2001-2015,126,124,181,170,11,170,0,5 (5ct 0st),1.459
2269,19,AJ Stewart (ENG),1989-2003,170,169,174,159,15,148,11,6 (6ct 0st),1.029
2270,20,A Flower (ZIM),1992-2003,213,212,173,141,32,133,8,5 (5ct 0st),0.816
2271,21,Q de Kock (SA),2013-2019,115,111,166,158,8,158,0,6 (5ct 1st),1.495
2272,22,DJ Richardson (SA),1991-1998,122,121,165,148,17,148,0,5 (5ct 0st),1.3630000000000002
2273,23,RT Ponting (AUS/ICC),1995-2012,375,372,160,160,0,0,160,3 (3ct 0st),0.43
2274,24,M Azharuddin (INDIA),1985-2000,334,332,156,156,0,0,156,4 (4ct 0st),0.469
2275,25,NR Mongia (INDIA),1994-2000,140,139,154,110,44,110,0,5 (4ct 1st),1.107
2276,26,BRM Taylor (ZIM),2004-2019,193,193,154,125,29,96,29,5 (5ct 0st),0.797
2277,27,T Taibu (Afr/ZIM),2001-2012,150,150,147,114,33,112,2,4 (4ct 0st),0.98
2278,28,AC Parore (NZ),1992-2002,179,178,141,116,25,111,5,5 (3ct 2st),0.792
2279,29,Sarfaraz Ahmed (PAK),2007-2019,116,114,140,116,24,116,0,6 (6ct 0st),1.228
2280,30,SR Tendulkar (INDIA),1989-2012,463,456,140,140,0,0,140,4 (4ct 0st),0.307
2281,31,LRPL Taylor (NZ),2006-2019,228,224,137,137,0,0,137,4 (4ct 0st),0.611
2282,32,Younis Khan (PAK),2000-2015,265,260,135,135,0,5,130,4 (4ct 0st),0.519
2283,33,SP Fleming (ICC/NZ),1994-2007,280,276,133,133,0,0,133,4 (4ct 0st),0.481
2284,34,JH Kallis (Afr/ICC/SA),1996-2014,328,324,131,131,0,0,131,3 (3ct 0st),0.4039999999999999
2285,35,M Muralitharan (Asia/ICC/SL),1993-2011,350,347,130,130,0,0,130,3 (3ct 0st),0.374
2286,36,AR Border (AUS),1979-1994,273,270,127,127,0,0,127,3 (3ct 0st),0.47
2287,37,Shahid Afridi (Asia/ICC/PAK),1996-2015,398,392,127,127,0,0,127,2 (2ct 0st),0.3229999999999999
2288,38,Khaled Mashud (BDESH),1995-2006,126,126,126,91,35,91,0,5 (3ct 2st),1.0
2289,39,TM Dilshan (SL),1999-2016,330,325,124,123,1,5,118,3 (3ct 0st),0.381
2290,40,CH Gayle (ICC/WI),1999-2019,301,294,124,124,0,0,124,3 (3ct 0st),0.421
2291,41,V Kohli (INDIA),2008-2019,242,240,124,124,0,0,124,3 (3ct 0st),0.516
2292,42,RW Marsh (AUS),1971-1984,92,92,124,120,4,120,0,5 (5ct 0st),1.347
2293,43,ST Jayasuriya (Asia/SL),1989-2011,445,441,123,123,0,0,123,3 (3ct 0st),0.278
2294,44,CL Hooper (WI),1987-2003,227,225,120,120,0,0,120,4 (4ct 0st),0.5329999999999999
2295,45,BC Lara (ICC/WI),1990-2007,299,296,120,120,0,0,120,3 (3ct 0st),0.405
2296,46,L Ronchi (AUS/NZ),2008-2017,85,83,117,105,12,105,0,4 (4ct 0st),1.409
2297,47,MS Wade (AUS),2012-2017,94,94,117,108,9,108,0,5 (5ct 0st),1.244
2298,48,Inzamam-ul-Haq (Asia/PAK),1991-2007,378,373,113,113,0,0,113,3 (3ct 0st),0.302
2299,49,SR Waugh (AUS),1986-2002,325,324,111,111,0,0,111,3 (3ct 0st),0.342
2300,0,KC Sangakkara (Asia/ICC/SL),2000-2015,404,397,501,402,99,383,19,5 (4ct 1st),1.261
2301,1,AC Gilchrist (AUS/ICC),1996-2008,287,286,472,417,55,417,0,6 (6ct 0st),1.65
2302,2,MS Dhoni (Asia/INDIA),2004-2019,350,345,444,321,123,321,0,6 (5ct 1st),1.286
2303,3,MV Boucher (Afr/SA),1998-2011,295,291,425,403,22,402,1,6 (6ct 0st),1.46
2304,4,Moin Khan (PAK),1990-2004,219,217,287,214,73,214,0,5 (5ct 0st),1.3219999999999998
2305,5,BB McCullum (NZ),2002-2016,260,257,277,262,15,227,35,5 (5ct 0st),1.077
2306,6,IA Healy (AUS),1988-1997,168,168,233,194,39,194,0,4 (4ct 0st),1.386
2307,7,Mushfiqur Rahim (BDESH),2006-2019,216,215,225,181,44,179,2,5 (5ct 0st),1.046
2308,8,Rashid Latif (PAK),1992-2003,166,164,220,182,38,182,0,5 (5ct 0st),1.341
2309,9,DPMD Jayawardene (Asia/SL),1998-2015,448,443,218,218,0,0,218,4 (4ct 0st),0.492
2310,10,R Dravid (Asia/ICC/INDIA),1996-2011,344,341,210,196,14,72,124,4 (4ct 0st),0.615
2311,11,RS Kaluwitharana (SL),1990-2004,189,188,207,132,75,131,1,5 (4ct 1st),1.101
2312,12,PJL Dujon (WI),1981-1991,169,168,204,183,21,183,0,4 (4ct 0st),1.214
2313,13,JC Buttler (ENG),2012-2019,142,138,202,171,31,171,0,6 (6ct 0st),1.463
2314,14,RD Jacobs (WI),1996-2004,147,145,189,160,29,160,0,6 (5ct 1st),1.3030000000000002
2315,15,Kamran Akmal (PAK),2002-2017,157,154,188,157,31,156,1,5 (4ct 1st),1.22
2316,16,D Ramdin (WI),2005-2016,139,137,188,181,7,181,0,5 (5ct 0st),1.372
2317,17,AB de Villiers (Afr/SA),2005-2018,228,223,181,176,5,93,83,5 (5ct 0st),0.8109999999999999
2318,18,BJ Haddin (AUS),2001-2015,126,124,181,170,11,170,0,5 (5ct 0st),1.459
2319,19,AJ Stewart (ENG),1989-2003,170,169,174,159,15,148,11,6 (6ct 0st),1.029
2320,20,A Flower (ZIM),1992-2003,213,212,173,141,32,133,8,5 (5ct 0st),0.816
2321,21,Q de Kock (SA),2013-2019,115,111,166,158,8,158,0,6 (5ct 1st),1.495
2322,22,DJ Richardson (SA),1991-1998,122,121,165,148,17,148,0,5 (5ct 0st),1.3630000000000002
2323,23,RT Ponting (AUS/ICC),1995-2012,375,372,160,160,0,0,160,3 (3ct 0st),0.43
2324,24,M Azharuddin (INDIA),1985-2000,334,332,156,156,0,0,156,4 (4ct 0st),0.469
2325,25,NR Mongia (INDIA),1994-2000,140,139,154,110,44,110,0,5 (4ct 1st),1.107
2326,26,BRM Taylor (ZIM),2004-2019,193,193,154,125,29,96,29,5 (5ct 0st),0.797
2327,27,T Taibu (Afr/ZIM),2001-2012,150,150,147,114,33,112,2,4 (4ct 0st),0.98
2328,28,AC Parore (NZ),1992-2002,179,178,141,116,25,111,5,5 (3ct 2st),0.792
2329,29,Sarfaraz Ahmed (PAK),2007-2019,116,114,140,116,24,116,0,6 (6ct 0st),1.228
2330,30,SR Tendulkar (INDIA),1989-2012,463,456,140,140,0,0,140,4 (4ct 0st),0.307
2331,31,LRPL Taylor (NZ),2006-2019,228,224,137,137,0,0,137,4 (4ct 0st),0.611
2332,32,Younis Khan (PAK),2000-2015,265,260,135,135,0,5,130,4 (4ct 0st),0.519
2333,33,SP Fleming (ICC/NZ),1994-2007,280,276,133,133,0,0,133,4 (4ct 0st),0.481
2334,34,JH Kallis (Afr/ICC/SA),1996-2014,328,324,131,131,0,0,131,3 (3ct 0st),0.4039999999999999
2335,35,M Muralitharan (Asia/ICC/SL),1993-2011,350,347,130,130,0,0,130,3 (3ct 0st),0.374
2336,36,AR Border (AUS),1979-1994,273,270,127,127,0,0,127,3 (3ct 0st),0.47
2337,37,Shahid Afridi (Asia/ICC/PAK),1996-2015,398,392,127,127,0,0,127,2 (2ct 0st),0.3229999999999999
2338,38,Khaled Mashud (BDESH),1995-2006,126,126,126,91,35,91,0,5 (3ct 2st),1.0
2339,39,TM Dilshan (SL),1999-2016,330,325,124,123,1,5,118,3 (3ct 0st),0.381
2340,40,CH Gayle (ICC/WI),1999-2019,301,294,124,124,0,0,124,3 (3ct 0st),0.421
2341,41,V Kohli (INDIA),2008-2019,242,240,124,124,0,0,124,3 (3ct 0st),0.516
2342,42,RW Marsh (AUS),1971-1984,92,92,124,120,4,120,0,5 (5ct 0st),1.347
2343,43,ST Jayasuriya (Asia/SL),1989-2011,445,441,123,123,0,0,123,3 (3ct 0st),0.278
2344,44,CL Hooper (WI),1987-2003,227,225,120,120,0,0,120,4 (4ct 0st),0.5329999999999999
2345,45,BC Lara (ICC/WI),1990-2007,299,296,120,120,0,0,120,3 (3ct 0st),0.405
2346,46,L Ronchi (AUS/NZ),2008-2017,85,83,117,105,12,105,0,4 (4ct 0st),1.409
2347,47,MS Wade (AUS),2012-2017,94,94,117,108,9,108,0,5 (5ct 0st),1.244
2348,48,Inzamam-ul-Haq (Asia/PAK),1991-2007,378,373,113,113,0,0,113,3 (3ct 0st),0.302
2349,49,SR Waugh (AUS),1986-2002,325,324,111,111,0,0,111,3 (3ct 0st),0.342
2350,0,KC Sangakkara (Asia/ICC/SL),2000-2015,404,397,501,402,99,383,19,5 (4ct 1st),1.261
2351,1,AC Gilchrist (AUS/ICC),1996-2008,287,286,472,417,55,417,0,6 (6ct 0st),1.65
2352,2,MS Dhoni (Asia/INDIA),2004-2019,350,345,444,321,123,321,0,6 (5ct 1st),1.286
2353,3,MV Boucher (Afr/SA),1998-2011,295,291,425,403,22,402,1,6 (6ct 0st),1.46
2354,4,Moin Khan (PAK),1990-2004,219,217,287,214,73,214,0,5 (5ct 0st),1.3219999999999998
2355,5,BB McCullum (NZ),2002-2016,260,257,277,262,15,227,35,5 (5ct 0st),1.077
2356,6,IA Healy (AUS),1988-1997,168,168,233,194,39,194,0,4 (4ct 0st),1.386
2357,7,Mushfiqur Rahim (BDESH),2006-2019,216,215,225,181,44,179,2,5 (5ct 0st),1.046
2358,8,Rashid Latif (PAK),1992-2003,166,164,220,182,38,182,0,5 (5ct 0st),1.341
2359,9,DPMD Jayawardene (Asia/SL),1998-2015,448,443,218,218,0,0,218,4 (4ct 0st),0.492
2360,10,R Dravid (Asia/ICC/INDIA),1996-2011,344,341,210,196,14,72,124,4 (4ct 0st),0.615
2361,11,RS Kaluwitharana (SL),1990-2004,189,188,207,132,75,131,1,5 (4ct 1st),1.101
2362,12,PJL Dujon (WI),1981-1991,169,168,204,183,21,183,0,4 (4ct 0st),1.214
2363,13,JC Buttler (ENG),2012-2019,142,138,202,171,31,171,0,6 (6ct 0st),1.463
2364,14,RD Jacobs (WI),1996-2004,147,145,189,160,29,160,0,6 (5ct 1st),1.3030000000000002
2365,15,Kamran Akmal (PAK),2002-2017,157,154,188,157,31,156,1,5 (4ct 1st),1.22
2366,16,D Ramdin (WI),2005-2016,139,137,188,181,7,181,0,5 (5ct 0st),1.372
2367,17,AB de Villiers (Afr/SA),2005-2018,228,223,181,176,5,93,83,5 (5ct 0st),0.8109999999999999
2368,18,BJ Haddin (AUS),2001-2015,126,124,181,170,11,170,0,5 (5ct 0st),1.459
2369,19,AJ Stewart (ENG),1989-2003,170,169,174,159,15,148,11,6 (6ct 0st),1.029
2370,20,A Flower (ZIM),1992-2003,213,212,173,141,32,133,8,5 (5ct 0st),0.816
2371,21,Q de Kock (SA),2013-2019,115,111,166,158,8,158,0,6 (5ct 1st),1.495
2372,22,DJ Richardson (SA),1991-1998,122,121,165,148,17,148,0,5 (5ct 0st),1.3630000000000002
2373,23,RT Ponting (AUS/ICC),1995-2012,375,372,160,160,0,0,160,3 (3ct 0st),0.43
2374,24,M Azharuddin (INDIA),1985-2000,334,332,156,156,0,0,156,4 (4ct 0st),0.469
2375,25,NR Mongia (INDIA),1994-2000,140,139,154,110,44,110,0,5 (4ct 1st),1.107
2376,26,BRM Taylor (ZIM),2004-2019,193,193,154,125,29,96,29,5 (5ct 0st),0.797
2377,27,T Taibu (Afr/ZIM),2001-2012,150,150,147,114,33,112,2,4 (4ct 0st),0.98
2378,28,AC Parore (NZ),1992-2002,179,178,141,116,25,111,5,5 (3ct 2st),0.792
2379,29,Sarfaraz Ahmed (PAK),2007-2019,116,114,140,116,24,116,0,6 (6ct 0st),1.228
2380,30,SR Tendulkar (INDIA),1989-2012,463,456,140,140,0,0,140,4 (4ct 0st),0.307
2381,31,LRPL Taylor (NZ),2006-2019,228,224,137,137,0,0,137,4 (4ct 0st),0.611
2382,32,Younis Khan (PAK),2000-2015,265,260,135,135,0,5,130,4 (4ct 0st),0.519
2383,33,SP Fleming (ICC/NZ),1994-2007,280,276,133,133,0,0,133,4 (4ct 0st),0.481
2384,34,JH Kallis (Afr/ICC/SA),1996-2014,328,324,131,131,0,0,131,3 (3ct 0st),0.4039999999999999
2385,35,M Muralitharan (Asia/ICC/SL),1993-2011,350,347,130,130,0,0,130,3 (3ct 0st),0.374
2386,36,AR Border (AUS),1979-1994,273,270,127,127,0,0,127,3 (3ct 0st),0.47
2387,37,Shahid Afridi (Asia/ICC/PAK),1996-2015,398,392,127,127,0,0,127,2 (2ct 0st),0.3229999999999999
2388,38,Khaled Mashud (BDESH),1995-2006,126,126,126,91,35,91,0,5 (3ct 2st),1.0
2389,39,TM Dilshan (SL),1999-2016,330,325,124,123,1,5,118,3 (3ct 0st),0.381
2390,40,CH Gayle (ICC/WI),1999-2019,301,294,124,124,0,0,124,3 (3ct 0st),0.421
2391,41,V Kohli (INDIA),2008-2019,242,240,124,124,0,0,124,3 (3ct 0st),0.516
2392,42,RW Marsh (AUS),1971-1984,92,92,124,120,4,120,0,5 (5ct 0st),1.347
2393,43,ST Jayasuriya (Asia/SL),1989-2011,445,441,123,123,0,0,123,3 (3ct 0st),0.278
2394,44,CL Hooper (WI),1987-2003,227,225,120,120,0,0,120,4 (4ct 0st),0.5329999999999999
2395,45,BC Lara (ICC/WI),1990-2007,299,296,120,120,0,0,120,3 (3ct 0st),0.405
2396,46,L Ronchi (AUS/NZ),2008-2017,85,83,117,105,12,105,0,4 (4ct 0st),1.409
2397,47,MS Wade (AUS),2012-2017,94,94,117,108,9,108,0,5 (5ct 0st),1.244
2398,48,Inzamam-ul-Haq (Asia/PAK),1991-2007,378,373,113,113,0,0,113,3 (3ct 0st),0.302
2399,49,SR Waugh (AUS),1986-2002,325,324,111,111,0,0,111,3 (3ct 0st),0.342
2400,0,KC Sangakkara (Asia/ICC/SL),2000-2015,404,397,501,402,99,383,19,5 (4ct 1st),1.261
2401,1,AC Gilchrist (AUS/ICC),1996-2008,287,286,472,417,55,417,0,6 (6ct 0st),1.65
2402,2,MS Dhoni (Asia/INDIA),2004-2019,350,345,444,321,123,321,0,6 (5ct 1st),1.286
2403,3,MV Boucher (Afr/SA),1998-2011,295,291,425,403,22,402,1,6 (6ct 0st),1.46
2404,4,Moin Khan (PAK),1990-2004,219,217,287,214,73,214,0,5 (5ct 0st),1.3219999999999998
2405,5,BB McCullum (NZ),2002-2016,260,257,277,262,15,227,35,5 (5ct 0st),1.077
2406,6,IA Healy (AUS),1988-1997,168,168,233,194,39,194,0,4 (4ct 0st),1.386
2407,7,Mushfiqur Rahim (BDESH),2006-2019,216,215,225,181,44,179,2,5 (5ct 0st),1.046
2408,8,Rashid Latif (PAK),1992-2003,166,164,220,182,38,182,0,5 (5ct 0st),1.341
2409,9,DPMD Jayawardene (Asia/SL),1998-2015,448,443,218,218,0,0,218,4 (4ct 0st),0.492
2410,10,R Dravid (Asia/ICC/INDIA),1996-2011,344,341,210,196,14,72,124,4 (4ct 0st),0.615
2411,11,RS Kaluwitharana (SL),1990-2004,189,188,207,132,75,131,1,5 (4ct 1st),1.101
2412,12,PJL Dujon (WI),1981-1991,169,168,204,183,21,183,0,4 (4ct 0st),1.214
2413,13,JC Buttler (ENG),2012-2019,142,138,202,171,31,171,0,6 (6ct 0st),1.463
2414,14,RD Jacobs (WI),1996-2004,147,145,189,160,29,160,0,6 (5ct 1st),1.3030000000000002
2415,15,Kamran Akmal (PAK),2002-2017,157,154,188,157,31,156,1,5 (4ct 1st),1.22
2416,16,D Ramdin (WI),2005-2016,139,137,188,181,7,181,0,5 (5ct 0st),1.372
2417,17,AB de Villiers (Afr/SA),2005-2018,228,223,181,176,5,93,83,5 (5ct 0st),0.8109999999999999
2418,18,BJ Haddin (AUS),2001-2015,126,124,181,170,11,170,0,5 (5ct 0st),1.459
2419,19,AJ Stewart (ENG),1989-2003,170,169,174,159,15,148,11,6 (6ct 0st),1.029
2420,20,A Flower (ZIM),1992-2003,213,212,173,141,32,133,8,5 (5ct 0st),0.816
2421,21,Q de Kock (SA),2013-2019,115,111,166,158,8,158,0,6 (5ct 1st),1.495
2422,22,DJ Richardson (SA),1991-1998,122,121,165,148,17,148,0,5 (5ct 0st),1.3630000000000002
2423,23,RT Ponting (AUS/ICC),1995-2012,375,372,160,160,0,0,160,3 (3ct 0st),0.43
2424,24,M Azharuddin (INDIA),1985-2000,334,332,156,156,0,0,156,4 (4ct 0st),0.469
2425,25,NR Mongia (INDIA),1994-2000,140,139,154,110,44,110,0,5 (4ct 1st),1.107
2426,26,BRM Taylor (ZIM),2004-2019,193,193,154,125,29,96,29,5 (5ct 0st),0.797
2427,27,T Taibu (Afr/ZIM),2001-2012,150,150,147,114,33,112,2,4 (4ct 0st),0.98
2428,28,AC Parore (NZ),1992-2002,179,178,141,116,25,111,5,5 (3ct 2st),0.792
2429,29,Sarfaraz Ahmed (PAK),2007-2019,116,114,140,116,24,116,0,6 (6ct 0st),1.228
2430,30,SR Tendulkar (INDIA),1989-2012,463,456,140,140,0,0,140,4 (4ct 0st),0.307
2431,31,LRPL Taylor (NZ),2006-2019,228,224,137,137,0,0,137,4 (4ct 0st),0.611
2432,32,Younis Khan (PAK),2000-2015,265,260,135,135,0,5,130,4 (4ct 0st),0.519
2433,33,SP Fleming (ICC/NZ),1994-2007,280,276,133,133,0,0,133,4 (4ct 0st),0.481
2434,34,JH Kallis (Afr/ICC/SA),1996-2014,328,324,131,131,0,0,131,3 (3ct 0st),0.4039999999999999
2435,35,M Muralitharan (Asia/ICC/SL),1993-2011,350,347,130,130,0,0,130,3 (3ct 0st),0.374
2436,36,AR Border (AUS),1979-1994,273,270,127,127,0,0,127,3 (3ct 0st),0.47
2437,37,Shahid Afridi (Asia/ICC/PAK),1996-2015,398,392,127,127,0,0,127,2 (2ct 0st),0.3229999999999999
2438,38,Khaled Mashud (BDESH),1995-2006,126,126,126,91,35,91,0,5 (3ct 2st),1.0
2439,39,TM Dilshan (SL),1999-2016,330,325,124,123,1,5,118,3 (3ct 0st),0.381
2440,40,CH Gayle (ICC/WI),1999-2019,301,294,124,124,0,0,124,3 (3ct 0st),0.421
2441,41,V Kohli (INDIA),2008-2019,242,240,124,124,0,0,124,3 (3ct 0st),0.516
2442,42,RW Marsh (AUS),1971-1984,92,92,124,120,4,120,0,5 (5ct 0st),1.347
2443,43,ST Jayasuriya (Asia/SL),1989-2011,445,441,123,123,0,0,123,3 (3ct 0st),0.278
2444,44,CL Hooper (WI),1987-2003,227,225,120,120,0,0,120,4 (4ct 0st),0.5329999999999999
2445,45,BC Lara (ICC/WI),1990-2007,299,296,120,120,0,0,120,3 (3ct 0st),0.405
2446,46,L Ronchi (AUS/NZ),2008-2017,85,83,117,105,12,105,0,4 (4ct 0st),1.409
2447,47,MS Wade (AUS),2012-2017,94,94,117,108,9,108,0,5 (5ct 0st),1.244
2448,48,Inzamam-ul-Haq (Asia/PAK),1991-2007,378,373,113,113,0,0,113,3 (3ct 0st),0.302
2449,49,SR Waugh (AUS),1986-2002,325,324,111,111,0,0,111,3 (3ct 0st),0.342
2450,0,KC Sangakkara (Asia/ICC/SL),2000-2015,404,397,501,402,99,383,19,5 (4ct 1st),1.261
2451,1,AC Gilchrist (AUS/ICC),1996-2008,287,286,472,417,55,417,0,6 (6ct 0st),1.65
2452,2,MS Dhoni (Asia/INDIA),2004-2019,350,345,444,321,123,321,0,6 (5ct 1st),1.286
2453,3,MV Boucher (Afr/SA),1998-2011,295,291,425,403,22,402,1,6 (6ct 0st),1.46
2454,4,Moin Khan (PAK),1990-2004,219,217,287,214,73,214,0,5 (5ct 0st),1.3219999999999998
2455,5,BB McCullum (NZ),2002-2016,260,257,277,262,15,227,35,5 (5ct 0st),1.077
2456,6,IA Healy (AUS),1988-1997,168,168,233,194,39,194,0,4 (4ct 0st),1.386
2457,7,Mushfiqur Rahim (BDESH),2006-2019,216,215,225,181,44,179,2,5 (5ct 0st),1.046
2458,8,Rashid Latif (PAK),1992-2003,166,164,220,182,38,182,0,5 (5ct 0st),1.341
2459,9,DPMD Jayawardene (Asia/SL),1998-2015,448,443,218,218,0,0,218,4 (4ct 0st),0.492
2460,10,R Dravid (Asia/ICC/INDIA),1996-2011,344,341,210,196,14,72,124,4 (4ct 0st),0.615
2461,11,RS Kaluwitharana (SL),1990-2004,189,188,207,132,75,131,1,5 (4ct 1st),1.101
2462,12,PJL Dujon (WI),1981-1991,169,168,204,183,21,183,0,4 (4ct 0st),1.214
2463,13,JC Buttler (ENG),2012-2019,142,138,202,171,31,171,0,6 (6ct 0st),1.463
2464,14,RD Jacobs (WI),1996-2004,147,145,189,160,29,160,0,6 (5ct 1st),1.3030000000000002
2465,15,Kamran Akmal (PAK),2002-2017,157,154,188,157,31,156,1,5 (4ct 1st),1.22
2466,16,D Ramdin (WI),2005-2016,139,137,188,181,7,181,0,5 (5ct 0st),1.372
2467,17,AB de Villiers (Afr/SA),2005-2018,228,223,181,176,5,93,83,5 (5ct 0st),0.8109999999999999
2468,18,BJ Haddin (AUS),2001-2015,126,124,181,170,11,170,0,5 (5ct 0st),1.459
2469,19,AJ Stewart (ENG),1989-2003,170,169,174,159,15,148,11,6 (6ct 0st),1.029
2470,20,A Flower (ZIM),1992-2003,213,212,173,141,32,133,8,5 (5ct 0st),0.816
2471,21,Q de Kock (SA),2013-2019,115,111,166,158,8,158,0,6 (5ct 1st),1.495
2472,22,DJ Richardson (SA),1991-1998,122,121,165,148,17,148,0,5 (5ct 0st),1.3630000000000002
2473,23,RT Ponting (AUS/ICC),1995-2012,375,372,160,160,0,0,160,3 (3ct 0st),0.43
2474,24,M Azharuddin (INDIA),1985-2000,334,332,156,156,0,0,156,4 (4ct 0st),0.469
2475,25,NR Mongia (INDIA),1994-2000,140,139,154,110,44,110,0,5 (4ct 1st),1.107
2476,26,BRM Taylor (ZIM),2004-2019,193,193,154,125,29,96,29,5 (5ct 0st),0.797
2477,27,T Taibu (Afr/ZIM),2001-2012,150,150,147,114,33,112,2,4 (4ct 0st),0.98
2478,28,AC Parore (NZ),1992-2002,179,178,141,116,25,111,5,5 (3ct 2st),0.792
2479,29,Sarfaraz Ahmed (PAK),2007-2019,116,114,140,116,24,116,0,6 (6ct 0st),1.228
2480,30,SR Tendulkar (INDIA),1989-2012,463,456,140,140,0,0,140,4 (4ct 0st),0.307
2481,31,LRPL Taylor (NZ),2006-2019,228,224,137,137,0,0,137,4 (4ct 0st),0.611
2482,32,Younis Khan (PAK),2000-2015,265,260,135,135,0,5,130,4 (4ct 0st),0.519
2483,33,SP Fleming (ICC/NZ),1994-2007,280,276,133,133,0,0,133,4 (4ct 0st),0.481
2484,34,JH Kallis (Afr/ICC/SA),1996-2014,328,324,131,131,0,0,131,3 (3ct 0st),0.4039999999999999
2485,35,M Muralitharan (Asia/ICC/SL),1993-2011,350,347,130,130,0,0,130,3 (3ct 0st),0.374
2486,36,AR Border (AUS),1979-1994,273,270,127,127,0,0,127,3 (3ct 0st),0.47
2487,37,Shahid Afridi (Asia/ICC/PAK),1996-2015,398,392,127,127,0,0,127,2 (2ct 0st),0.3229999999999999
2488,38,Khaled Mashud (BDESH),1995-2006,126,126,126,91,35,91,0,5 (3ct 2st),1.0
2489,39,TM Dilshan (SL),1999-2016,330,325,124,123,1,5,118,3 (3ct 0st),0.381
2490,40,CH Gayle (ICC/WI),1999-2019,301,294,124,124,0,0,124,3 (3ct 0st),0.421
2491,41,V Kohli (INDIA),2008-2019,242,240,124,124,0,0,124,3 (3ct 0st),0.516
2492,42,RW Marsh (AUS),1971-1984,92,92,124,120,4,120,0,5 (5ct 0st),1.347
2493,43,ST Jayasuriya (Asia/SL),1989-2011,445,441,123,123,0,0,123,3 (3ct 0st),0.278
2494,44,CL Hooper (WI),1987-2003,227,225,120,120,0,0,120,4 (4ct 0st),0.5329999999999999
2495,45,BC Lara (ICC/WI),1990-2007,299,296,120,120,0,0,120,3 (3ct 0st),0.405
2496,46,L Ronchi (AUS/NZ),2008-2017,85,83,117,105,12,105,0,4 (4ct 0st),1.409
2497,47,MS Wade (AUS),2012-2017,94,94,117,108,9,108,0,5 (5ct 0st),1.244
2498,48,Inzamam-ul-Haq (Asia/PAK),1991-2007,378,373,113,113,0,0,113,3 (3ct 0st),0.302
2499,49,SR Waugh (AUS),1986-2002,325,324,111,111,0,0,111,3 (3ct 0st),0.342
2500,0,KC Sangakkara (Asia/ICC/SL),2000-2015,404,397,501,402,99,383,19,5 (4ct 1st),1.261
2501,1,AC Gilchrist (AUS/ICC),1996-2008,287,286,472,417,55,417,0,6 (6ct 0st),1.65
2502,2,MS Dhoni (Asia/INDIA),2004-2019,350,345,444,321,123,321,0,6 (5ct 1st),1.286
2503,3,MV Boucher (Afr/SA),1998-2011,295,291,425,403,22,402,1,6 (6ct 0st),1.46
2504,4,Moin Khan (PAK),1990-2004,219,217,287,214,73,214,0,5 (5ct 0st),1.3219999999999998
2505,5,BB McCullum (NZ),2002-2016,260,257,277,262,15,227,35,5 (5ct 0st),1.077
2506,6,IA Healy (AUS),1988-1997,168,168,233,194,39,194,0,4 (4ct 0st),1.386
2507,7,Mushfiqur Rahim (BDESH),2006-2019,216,215,225,181,44,179,2,5 (5ct 0st),1.046
2508,8,Rashid Latif (PAK),1992-2003,166,164,220,182,38,182,0,5 (5ct 0st),1.341
2509,9,DPMD Jayawardene (Asia/SL),1998-2015,448,443,218,218,0,0,218,4 (4ct 0st),0.492
2510,10,R Dravid (Asia/ICC/INDIA),1996-2011,344,341,210,196,14,72,124,4 (4ct 0st),0.615
2511,11,RS Kaluwitharana (SL),1990-2004,189,188,207,132,75,131,1,5 (4ct 1st),1.101
2512,12,PJL Dujon (WI),1981-1991,169,168,204,183,21,183,0,4 (4ct 0st),1.214
2513,13,JC Buttler (ENG),2012-2019,142,138,202,171,31,171,0,6 (6ct 0st),1.463
2514,14,RD Jacobs (WI),1996-2004,147,145,189,160,29,160,0,6 (5ct 1st),1.3030000000000002
2515,15,Kamran Akmal (PAK),2002-2017,157,154,188,157,31,156,1,5 (4ct 1st),1.22
2516,16,D Ramdin (WI),2005-2016,139,137,188,181,7,181,0,5 (5ct 0st),1.372
2517,17,AB de Villiers (Afr/SA),2005-2018,228,223,181,176,5,93,83,5 (5ct 0st),0.8109999999999999
2518,18,BJ Haddin (AUS),2001-2015,126,124,181,170,11,170,0,5 (5ct 0st),1.459
2519,19,AJ Stewart (ENG),1989-2003,170,169,174,159,15,148,11,6 (6ct 0st),1.029
2520,20,A Flower (ZIM),1992-2003,213,212,173,141,32,133,8,5 (5ct 0st),0.816
2521,21,Q de Kock (SA),2013-2019,115,111,166,158,8,158,0,6 (5ct 1st),1.495
2522,22,DJ Richardson (SA),1991-1998,122,121,165,148,17,148,0,5 (5ct 0st),1.3630000000000002
2523,23,RT Ponting (AUS/ICC),1995-2012,375,372,160,160,0,0,160,3 (3ct 0st),0.43
2524,24,M Azharuddin (INDIA),1985-2000,334,332,156,156,0,0,156,4 (4ct 0st),0.469
2525,25,NR Mongia (INDIA),1994-2000,140,139,154,110,44,110,0,5 (4ct 1st),1.107
2526,26,BRM Taylor (ZIM),2004-2019,193,193,154,125,29,96,29,5 (5ct 0st),0.797
2527,27,T Taibu (Afr/ZIM),2001-2012,150,150,147,114,33,112,2,4 (4ct 0st),0.98
2528,28,AC Parore (NZ),1992-2002,179,178,141,116,25,111,5,5 (3ct 2st),0.792
2529,29,Sarfaraz Ahmed (PAK),2007-2019,116,114,140,116,24,116,0,6 (6ct 0st),1.228
2530,30,SR Tendulkar (INDIA),1989-2012,463,456,140,140,0,0,140,4 (4ct 0st),0.307
2531,31,LRPL Taylor (NZ),2006-2019,228,224,137,137,0,0,137,4 (4ct 0st),0.611
2532,32,Younis Khan (PAK),2000-2015,265,260,135,135,0,5,130,4 (4ct 0st),0.519
2533,33,SP Fleming (ICC/NZ),1994-2007,280,276,133,133,0,0,133,4 (4ct 0st),0.481
2534,34,JH Kallis (Afr/ICC/SA),1996-2014,328,324,131,131,0,0,131,3 (3ct 0st),0.4039999999999999
2535,35,M Muralitharan (Asia/ICC/SL),1993-2011,350,347,130,130,0,0,130,3 (3ct 0st),0.374
2536,36,AR Border (AUS),1979-1994,273,270,127,127,0,0,127,3 (3ct 0st),0.47
2537,37,Shahid Afridi (Asia/ICC/PAK),1996-2015,398,392,127,127,0,0,127,2 (2ct 0st),0.3229999999999999
2538,38,Khaled Mashud (BDESH),1995-2006,126,126,126,91,35,91,0,5 (3ct 2st),1.0
2539,39,TM Dilshan (SL),1999-2016,330,325,124,123,1,5,118,3 (3ct 0st),0.381
2540,40,CH Gayle (ICC/WI),1999-2019,301,294,124,124,0,0,124,3 (3ct 0st),0.421
2541,41,V Kohli (INDIA),2008-2019,242,240,124,124,0,0,124,3 (3ct 0st),0.516
2542,42,RW Marsh (AUS),1971-1984,92,92,124,120,4,120,0,5 (5ct 0st),1.347
2543,43,ST Jayasuriya (Asia/SL),1989-2011,445,441,123,123,0,0,123,3 (3ct 0st),0.278
2544,44,CL Hooper (WI),1987-2003,227,225,120,120,0,0,120,4 (4ct 0st),0.5329999999999999
2545,45,BC Lara (ICC/WI),1990-2007,299,296,120,120,0,0,120,3 (3ct 0st),0.405
2546,46,L Ronchi (AUS/NZ),2008-2017,85,83,117,105,12,105,0,4 (4ct 0st),1.409
2547,47,MS Wade (AUS),2012-2017,94,94,117,108,9,108,0,5 (5ct 0st),1.244
2548,48,Inzamam-ul-Haq (Asia/PAK),1991-2007,378,373,113,113,0,0,113,3 (3ct 0st),0.302
2549,49,SR Waugh (AUS),1986-2002,325,324,111,111,0,0,111,3 (3ct 0st),0.342
2550,0,KC Sangakkara (Asia/ICC/SL),2000-2015,404,397,501,402,99,383,19,5 (4ct 1st),1.261
2551,1,AC Gilchrist (AUS/ICC),1996-2008,287,286,472,417,55,417,0,6 (6ct 0st),1.65
2552,2,MS Dhoni (Asia/INDIA),2004-2019,350,345,444,321,123,321,0,6 (5ct 1st),1.286
2553,3,MV Boucher (Afr/SA),1998-2011,295,291,425,403,22,402,1,6 (6ct 0st),1.46
2554,4,Moin Khan (PAK),1990-2004,219,217,287,214,73,214,0,5 (5ct 0st),1.3219999999999998
2555,5,BB McCullum (NZ),2002-2016,260,257,277,262,15,227,35,5 (5ct 0st),1.077
2556,6,IA Healy (AUS),1988-1997,168,168,233,194,39,194,0,4 (4ct 0st),1.386
2557,7,Mushfiqur Rahim (BDESH),2006-2019,216,215,225,181,44,179,2,5 (5ct 0st),1.046
2558,8,Rashid Latif (PAK),1992-2003,166,164,220,182,38,182,0,5 (5ct 0st),1.341
2559,9,DPMD Jayawardene (Asia/SL),1998-2015,448,443,218,218,0,0,218,4 (4ct 0st),0.492
2560,10,R Dravid (Asia/ICC/INDIA),1996-2011,344,341,210,196,14,72,124,4 (4ct 0st),0.615
2561,11,RS Kaluwitharana (SL),1990-2004,189,188,207,132,75,131,1,5 (4ct 1st),1.101
2562,12,PJL Dujon (WI),1981-1991,169,168,204,183,21,183,0,4 (4ct 0st),1.214
2563,13,JC Buttler (ENG),2012-2019,142,138,202,171,31,171,0,6 (6ct 0st),1.463
2564,14,RD Jacobs (WI),1996-2004,147,145,189,160,29,160,0,6 (5ct 1st),1.3030000000000002
2565,15,Kamran Akmal (PAK),2002-2017,157,154,188,157,31,156,1,5 (4ct 1st),1.22
2566,16,D Ramdin (WI),2005-2016,139,137,188,181,7,181,0,5 (5ct 0st),1.372
2567,17,AB de Villiers (Afr/SA),2005-2018,228,223,181,176,5,93,83,5 (5ct 0st),0.8109999999999999
2568,18,BJ Haddin (AUS),2001-2015,126,124,181,170,11,170,0,5 (5ct 0st),1.459
2569,19,AJ Stewart (ENG),1989-2003,170,169,174,159,15,148,11,6 (6ct 0st),1.029
2570,20,A Flower (ZIM),1992-2003,213,212,173,141,32,133,8,5 (5ct 0st),0.816
2571,21,Q de Kock (SA),2013-2019,115,111,166,158,8,158,0,6 (5ct 1st),1.495
2572,22,DJ Richardson (SA),1991-1998,122,121,165,148,17,148,0,5 (5ct 0st),1.3630000000000002
2573,23,RT Ponting (AUS/ICC),1995-2012,375,372,160,160,0,0,160,3 (3ct 0st),0.43
2574,24,M Azharuddin (INDIA),1985-2000,334,332,156,156,0,0,156,4 (4ct 0st),0.469
2575,25,NR Mongia (INDIA),1994-2000,140,139,154,110,44,110,0,5 (4ct 1st),1.107
2576,26,BRM Taylor (ZIM),2004-2019,193,193,154,125,29,96,29,5 (5ct 0st),0.797
2577,27,T Taibu (Afr/ZIM),2001-2012,150,150,147,114,33,112,2,4 (4ct 0st),0.98
2578,28,AC Parore (NZ),1992-2002,179,178,141,116,25,111,5,5 (3ct 2st),0.792
2579,29,Sarfaraz Ahmed (PAK),2007-2019,116,114,140,116,24,116,0,6 (6ct 0st),1.228
2580,30,SR Tendulkar (INDIA),1989-2012,463,456,140,140,0,0,140,4 (4ct 0st),0.307
2581,31,LRPL Taylor (NZ),2006-2019,228,224,137,137,0,0,137,4 (4ct 0st),0.611
2582,32,Younis Khan (PAK),2000-2015,265,260,135,135,0,5,130,4 (4ct 0st),0.519
2583,33,SP Fleming (ICC/NZ),1994-2007,280,276,133,133,0,0,133,4 (4ct 0st),0.481
2584,34,JH Kallis (Afr/ICC/SA),1996-2014,328,324,131,131,0,0,131,3 (3ct 0st),0.4039999999999999
2585,35,M Muralitharan (Asia/ICC/SL),1993-2011,350,347,130,130,0,0,130,3 (3ct 0st),0.374
2586,36,AR Border (AUS),1979-1994,273,270,127,127,0,0,127,3 (3ct 0st),0.47
2587,37,Shahid Afridi (Asia/ICC/PAK),1996-2015,398,392,127,127,0,0,127,2 (2ct 0st),0.3229999999999999
2588,38,Khaled Mashud (BDESH),1995-2006,126,126,126,91,35,91,0,5 (3ct 2st),1.0
2589,39,TM Dilshan (SL),1999-2016,330,325,124,123,1,5,118,3 (3ct 0st),0.381
2590,40,CH Gayle (ICC/WI),1999-2019,301,294,124,124,0,0,124,3 (3ct 0st),0.421
2591,41,V Kohli (INDIA),2008-2019,242,240,124,124,0,0,124,3 (3ct 0st),0.516
2592,42,RW Marsh (AUS),1971-1984,92,92,124,120,4,120,0,5 (5ct 0st),1.347
2593,43,ST Jayasuriya (Asia/SL),1989-2011,445,441,123,123,0,0,123,3 (3ct 0st),0.278
2594,44,CL Hooper (WI),1987-2003,227,225,120,120,0,0,120,4 (4ct 0st),0.5329999999999999
2595,45,BC Lara (ICC/WI),1990-2007,299,296,120,120,0,0,120,3 (3ct 0st),0.405
2596,46,L Ronchi (AUS/NZ),2008-2017,85,83,117,105,12,105,0,4 (4ct 0st),1.409
2597,47,MS Wade (AUS),2012-2017,94,94,117,108,9,108,0,5 (5ct 0st),1.244
2598,48,Inzamam-ul-Haq (Asia/PAK),1991-2007,378,373,113,113,0,0,113,3 (3ct 0st),0.302
2599,49,SR Waugh (AUS),1986-2002,325,324,111,111,0,0,111,3 (3ct 0st),0.342
