,Unnamed: 0,Player,Span,Mat,Inns,Dis,Ct,St,Ct Wk,Ct Fi,MD,D/I
0,0,MS Dhoni (INDIA),2006-2019,98,97,91,57,34,57,0,5 (5ct 0st),0.938
1,1,AB de Villiers (SA),2006-2017,78,78,72,65,7,21,44,4 (4ct 0st),0.9229999999999999
2,2,D Ramdin (WI),2006-2019,71,71,63,43,20,43,0,4 (4ct 0st),0.887
3,3,Kamran Akmal (PAK),2006-2017,58,58,60,28,32,28,0,4 (0ct 4st),1.034
4,4,Mushfiqur Rahim (BDESH),2006-2019,84,82,59,31,28,30,1,3 (1ct 2st),0.7190000000000001
5,5,Mohammad Shahzad (AFG),2010-2018,65,65,54,26,28,26,0,5 (3ct 2st),0.83
6,6,DA Miller (SA/World),2010-2019,72,72,52,51,1,1,50,4 (4ct 0st),0.722
7,7,Umar Akmal (PAK),2009-2019,84,84,52,50,2,11,39,3 (3ct 0st),0.619
8,8,Shoaib Malik (ICC/PAK),2006-2019,111,111,50,50,0,0,50,3 (3ct 0st),0.45
9,9,Q de Kock (SA),2012-2019,38,38,46,36,10,36,0,4 (3ct 1st),1.21
10,10,MJ Guptill (NZ),2009-2019,83,82,46,46,0,0,46,3 (3ct 0st),0.56
11,11,GC Wilson (IRE),2008-2019,78,76,46,39,7,28,11,4 (3ct 1st),0.605
12,12,KC Sangakkara (SL),2006-2014,56,56,45,25,20,25,0,3 (2ct 1st),0.8029999999999999
13,13,Sarfaraz Ahmed (PAK),2010-2019,58,58,45,35,10,35,0,3 (3ct 0st),0.775
14,14,BB McCullum (NZ),2005-2015,71,71,44,36,8,24,12,3 (3ct 0st),0.619
15,15,LRPL Taylor (NZ),2006-2019,95,95,44,44,0,0,44,3 (3ct 0st),0.46299999999999997
16,16,DA Warner (AUS),2009-2019,76,76,43,43,0,0,43,3 (3ct 0st),0.565
17,17,SK Raina (INDIA),2006-2018,78,78,42,42,0,0,42,3 (3ct 0st),0.5379999999999999
18,18,Mohammad Nabi (AFG),2010-2019,75,75,41,41,0,0,41,3 (3ct 0st),0.546
19,19,RG Sharma (INDIA),2007-2019,104,104,38,38,0,0,38,3 (3ct 0st),0.365
20,20,LD Chandimal (SL),2010-2018,54,54,37,32,5,15,17,4 (4ct 0st),0.685
21,21,V Kohli (INDIA),2010-2019,75,75,37,37,0,0,37,3 (3ct 0st),0.493
22,22,EJG Morgan (ENG),2009-2019,86,86,37,37,0,0,37,3 (3ct 0st),0.43
23,23,GH Dockrell (IRE),2010-2019,73,70,36,36,0,0,36,3 (3ct 0st),0.514
24,24,DJ Bravo (WI),2006-2016,66,66,35,35,0,0,35,3 (3ct 0st),0.53
25,25,JP Duminy (SA),2007-2019,81,81,35,35,0,0,35,2 (2ct 0st),0.43200000000000005
26,26,KJ O'Brien (IRE),2008-2019,90,86,34,34,0,0,34,2 (2ct 0st),0.395
27,27,KA Pollard (WI),2008-2019,68,68,34,34,0,0,34,2 (2ct 0st),0.5
28,28,MH Cross (SCOT),2013-2019,43,41,33,22,11,22,0,3 (2ct 1st),0.804
29,29,TM Dilshan (SL),2006-2016,80,80,33,31,2,5,26,2 (2ct 0st),0.41200000000000003
30,30,AD Hales (ENG),2011-2019,60,59,32,32,0,0,32,2 (2ct 0st),0.542
31,31,BN Cooper (NL),2013-2019,51,50,31,31,0,0,31,2 (2ct 0st),0.62
32,32,Mahmudullah (BDESH),2007-2019,83,81,31,31,0,0,31,2 (2ct 0st),0.382
33,33,DJG Sammy (WI/World),2007-2017,68,68,31,31,0,0,31,4 (4ct 0st),0.455
34,34,JM Bairstow (ENG),2011-2019,34,34,30,30,0,8,22,2 (2ct 0st),0.882
35,35,GJ Maxwell (AUS),2012-2019,61,60,30,30,0,0,30,2 (2ct 0st),0.5
36,36,NLTC Perera (ICC/SL/World),2010-2019,79,79,30,30,0,0,30,2 (2ct 0st),0.379
37,37,L Ronchi (AUS/ICC/NZ),2008-2018,33,33,30,24,6,24,0,3 (3ct 0st),0.909
38,38,Shahid Afridi (ICC/PAK),2006-2018,99,99,30,30,0,0,30,3 (3ct 0st),0.303
39,39,TG Southee (NZ),2008-2019,66,65,29,29,0,0,29,2 (2ct 0st),0.446
40,40,PW Borren (NL),2008-2017,43,41,28,28,0,0,28,4 (4ct 0st),0.682
41,41,SA Edwards (NL),2018-2019,29,28,28,24,4,24,0,3 (3ct 0st),1.0
42,42,PM Seelaar (NL),2008-2019,69,67,28,28,0,0,28,2 (2ct 0st),0.41700000000000004
43,43,W Barresi (NL),2012-2019,42,40,27,26,1,26,0,4 (4ct 0st),0.675
44,44,JC Buttler (ENG),2011-2018,66,65,27,23,4,21,2,3 (3ct 0st),0.415
45,45,CS MacLeod (SCOT),2009-2019,49,49,27,27,0,0,27,4 (4ct 0st),0.551
46,46,Najibullah Zadran (AFG),2012-2019,57,57,27,27,0,0,27,2 (2ct 0st),0.473
47,47,NJ O'Brien (IRE),2008-2016,30,28,27,17,10,15,2,4 (3ct 1st),0.9640000000000001
48,48,KS Williamson (NZ),2011-2019,57,56,27,27,0,0,27,3 (3ct 0st),0.48200000000000004
49,49,NL McCullum (NZ),2007-2016,63,63,26,26,0,0,26,3 (3ct 0st),0.41200000000000003
50,0,H Masakadza (ZIM),2006-2019,66,66,25,25,0,0,25,3 (3ct 0st),0.37799999999999995
51,1,Mohammad Hafeez (PAK),2006-2018,89,89,25,25,0,0,25,2 (2ct 0st),0.28
52,2,Sabbir Rahman (BDESH),2014-2019,44,43,25,25,0,0,25,3 (3ct 0st),0.581
53,3,AJ Finch (AUS),2011-2019,58,57,24,24,0,0,24,3 (3ct 0st),0.42100000000000004
54,4,DJ Hussey (AUS),2008-2012,39,39,24,24,0,0,24,2 (2ct 0st),0.615
55,5,BJ Haddin (AUS),2006-2014,34,34,23,17,6,17,0,3 (3ct 0st),0.6759999999999999
56,6,CJ Jordan (ENG),2014-2019,43,43,23,23,0,0,23,3 (3ct 0st),0.534
57,7,AD Mathews (SL),2009-2018,72,72,23,23,0,0,23,2 (2ct 0st),0.319
58,8,HH Pandya (INDIA),2016-2019,40,40,23,23,0,0,23,2 (2ct 0st),0.575
59,9,Soumya Sarkar (BDESH),2015-2019,46,45,23,23,0,0,23,2 (2ct 0st),0.511
60,10,SR Thompson (IRE),2014-2019,41,39,23,23,0,0,23,3 (3ct 0st),0.589
61,11,CL White (AUS),2007-2014,47,47,23,23,0,0,23,2 (2ct 0st),0.489
62,12,AT Carey (AUS),2018-2019,25,24,22,13,9,13,0,3 (1ct 2st),0.9159999999999999
63,13,ADS Fletcher (WI),2008-2018,42,42,22,21,1,10,11,3 (2ct 1st),0.523
64,14,WTS Porterfield (IRE),2008-2018,61,59,22,22,0,0,22,2 (2ct 0st),0.37200000000000005
65,15,PR Stirling (IRE),2009-2019,72,71,22,22,0,0,22,3 (3ct 0st),0.309
66,16,SCJ Broad (ENG),2006-2014,56,56,21,21,0,0,21,3 (3ct 0st),0.375
67,17,F du Plessis (SA/World),2012-2019,44,44,21,21,0,0,21,2 (2ct 0st),0.47700000000000004
68,18,SPD Smith (AUS),2010-2019,36,36,21,21,0,0,21,3 (3ct 0st),0.583
69,19,Asghar Afghan (AFG),2010-2019,66,66,20,20,0,0,20,2 (2ct 0st),0.303
70,20,MEK Hussey (AUS),2005-2012,38,38,20,20,0,0,20,3 (3ct 0st),0.526
71,21,RA Jadeja (INDIA),2009-2019,46,46,20,20,0,0,20,2 (2ct 0st),0.434
72,22,C Kieswetter (ENG),2010-2012,25,25,20,17,3,17,0,3 (2ct 1st),0.8
73,23,SL Malinga (SL),2006-2019,79,79,20,20,0,0,20,2 (2ct 0st),0.253
74,24,CO Obuya (KENYA),2007-2019,35,35,20,20,0,0,20,2 (2ct 0st),0.5710000000000001
75,25,L Siaka (PNG),2015-2019,26,26,20,20,0,0,20,4 (4ct 0st),0.769
76,26,LMP Simmons (WI),2007-2019,49,49,20,20,0,1,19,3 (3ct 0st),0.408
77,27,SR Watson (AUS),2006-2016,58,58,20,20,0,0,20,2 (2ct 0st),0.344
78,28,HM Amla (SA/World),2009-2018,44,44,19,19,0,0,19,2 (2ct 0st),0.431
79,29,CJ Anderson (NZ),2012-2018,31,31,19,19,0,0,19,4 (4ct 0st),0.612
80,30,MV Boucher (SA),2005-2010,25,25,19,18,1,18,0,3 (3ct 0st),0.76
81,31,CR Brathwaite (WI),2011-2019,41,41,19,19,0,0,19,2 (2ct 0st),0.46299999999999997
82,32,E Chigumbura (ZIM),2006-2019,54,54,19,19,0,0,19,2 (2ct 0st),0.35100000000000003
83,33,KJ Coetzer (SCOT),2008-2019,58,56,19,19,0,0,19,2 (2ct 0st),0.33899999999999997
84,34,KD Karthik (ICC/INDIA),2006-2019,32,31,19,14,5,6,8,3 (3ct 0st),0.612
85,35,R Mutumbami (ZIM),2015-2019,22,22,19,15,4,11,4,4 (4ct 0st),0.863
86,36,RR Patel (KENYA),2008-2019,30,30,19,19,0,0,19,3 (3ct 0st),0.633
87,37,Shakib Al Hasan (BDESH),2006-2019,76,75,19,19,0,0,19,2 (2ct 0st),0.253
88,38,BRM Taylor (ZIM),2006-2019,38,38,19,17,2,15,2,3 (3ct 0st),0.5
89,39,RE van der Merwe (NL/SA),2009-2019,43,42,19,19,0,0,19,2 (2ct 0st),0.452
90,40,C de Grandhomme (NZ),2012-2019,33,33,18,18,0,0,18,4 (4ct 0st),0.545
91,41,S Dhawan (INDIA),2011-2019,58,58,18,18,0,0,18,2 (2ct 0st),0.31
92,42,Gulbadin Naib (AFG),2012-2019,45,45,18,18,0,0,18,2 (2ct 0st),0.4
93,43,MA Leask (SCOT),2013-2019,31,29,18,18,0,0,18,3 (3ct 0st),0.62
94,44,C Munro (NZ),2012-2019,60,59,18,18,0,0,18,2 (2ct 0st),0.305
95,45,JE Root (ENG),2012-2019,32,32,18,18,0,0,18,2 (2ct 0st),0.562
96,46,Samiullah Shinwari (AFG),2010-2019,62,62,18,18,0,0,18,1 (1ct 0st),0.29
97,47,GC Smith (SA),2005-2011,33,33,18,18,0,0,18,2 (2ct 0st),0.545
98,48,Tamim Iqbal (BDESH/ICC/World),2007-2018,75,73,18,18,0,0,18,2 (2ct 0st),0.24600000000000002
99,49,Umar Gul (PAK),2007-2016,60,60,18,18,0,0,18,2 (2ct 0st),0.3
100,0,J Botha (SA),2006-2012,40,40,17,17,0,0,17,2 (2ct 0st),0.425
101,1,AC Gilchrist (AUS),2005-2008,13,13,17,17,0,17,0,4 (4ct 0st),1.307
102,2,DPMD Jayawardene (SL),2006-2014,55,55,17,17,0,0,17,2 (2ct 0st),0.309
103,3,CK Kapugedera (SL),2006-2017,43,43,17,17,0,0,17,3 (3ct 0st),0.395
104,4,KMDN Kulasekara (SL),2008-2017,58,58,17,17,0,0,17,2 (2ct 0st),0.293
105,5,JA Morkel (SA),2005-2015,50,50,17,17,0,0,17,2 (2ct 0st),0.34
106,6,MDKJ Perera (SL),2013-2019,42,42,17,13,4,7,6,3 (2ct 1st),0.40399999999999997
107,7,Sikandar Raza (ZIM),2013-2019,32,32,17,17,0,0,17,2 (2ct 0st),0.531
108,8,BDH Stevens (JER),2019-2019,17,17,17,17,0,0,17,3 (3ct 0st),1.0
109,9,Sultan Ahmed (OMAN),2015-2017,17,16,17,14,3,14,0,3 (3ct 0st),1.062
110,10,Babar Hayat (HKG),2014-2017,24,24,16,16,0,0,16,4 (4ct 0st),0.6659999999999999
111,11,SW Billings (ENG/ICC),2015-2019,26,26,16,15,1,4,11,3 (2ct 1st),0.615
112,12,K Doriga (PNG),2019-2019,17,17,16,15,1,15,0,5 (5ct 0st),0.941
113,13,Hamza Tariq (CAN),2013-2019,15,15,16,12,4,12,0,3 (3ct 0st),1.0659999999999998
114,14,JW Jenner (JER),2019-2019,17,17,16,16,0,0,16,4 (4ct 0st),0.941
115,15,P Khadka (NEPAL),2014-2019,30,30,16,16,0,0,16,3 (3ct 0st),0.5329999999999999
116,16,Nawroz Mangal (AFG),2010-2017,32,32,16,16,0,0,16,3 (3ct 0st),0.5
117,17,AM Rahane (INDIA),2011-2016,20,20,16,16,0,0,16,4 (4ct 0st),0.8
118,18,WB Rankin (ENG/IRE),2009-2019,48,47,16,16,0,0,16,2 (2ct 0st),0.34
119,19,Rashid Khan (AFG/ICC),2015-2019,45,45,16,16,0,0,16,2 (2ct 0st),0.355
120,20,Shafiqullah (AFG),2010-2019,46,46,16,14,2,1,13,3 (3ct 0st),0.34700000000000003
121,21,Ahmed Shehzad (PAK),2009-2019,59,59,15,15,0,0,15,2 (2ct 0st),0.254
122,22,Babar Azam (PAK),2016-2019,36,36,15,15,0,0,15,2 (2ct 0st),0.41600000000000004
123,23,B Bhandari (NEPAL),2014-2019,27,27,15,10,5,7,3,3 (3ct 0st),0.555
124,24,PD Collingwood (ENG/World),2005-2017,36,36,15,15,0,0,15,2 (2ct 0st),0.41600000000000004
125,25,CH Gayle (WI),2006-2019,58,58,15,15,0,0,15,1 (1ct 0st),0.258
126,26,Ghulam Shabber (UAE),2016-2019,17,17,15,14,1,14,0,2 (2ct 0st),0.882
127,27,ZE Green (NAM),2019-2019,16,16,15,10,5,10,0,4 (3ct 1st),0.937
128,28,Nasir Hossain (BDESH),2011-2016,31,30,15,15,0,0,15,2 (2ct 0st),0.5
129,29,SW Poynter (IRE),2015-2019,25,23,15,13,2,8,5,2 (2ct 0st),0.652
130,30,MS Wade (AUS),2011-2016,26,26,15,13,2,13,0,3 (2ct 1st),0.5760000000000001
131,31,CAK Walton (WI),2014-2018,19,19,15,13,2,10,3,3 (3ct 0st),0.789
132,32,SC Williams (ZIM),2006-2019,38,38,15,15,0,0,15,2 (2ct 0st),0.39399999999999996
133,33,JJ Atkinson (HKG),2014-2016,13,13,14,14,0,14,0,3 (3ct 0st),1.0759999999999998
134,34,A Balbirnie (IRE),2015-2019,37,35,14,14,0,0,14,2 (2ct 0st),0.4
135,35,F Behardien (SA),2012-2018,38,38,14,14,0,0,14,2 (2ct 0st),0.368
136,36,Fakhar Zaman (PAK),2017-2019,34,34,14,14,0,0,14,2 (2ct 0st),0.41100000000000003
137,37,Imad Wasim (PAK),2015-2019,41,41,14,14,0,0,14,2 (2ct 0st),0.341
138,38,IA Karim (KENYA),2013-2019,16,16,14,11,3,9,2,5 (2ct 3st),0.875
139,39,G Malla (NEPAL),2014-2019,24,24,14,14,0,0,14,3 (3ct 0st),0.583
140,40,Misbah-ul-Haq (PAK),2007-2012,39,39,14,14,0,0,14,2 (2ct 0st),0.358
141,41,MP O'Dowd (NL),2015-2019,36,35,14,14,0,0,14,2 (2ct 0st),0.4
142,42,KP Pietersen (ENG),2005-2013,37,36,14,14,0,0,14,3 (3ct 0st),0.38799999999999996
143,43,MJ Santner (NZ),2015-2019,39,38,14,14,0,0,14,2 (2ct 0st),0.368
144,44,A Vala (PNG),2015-2019,26,26,14,14,0,0,14,3 (3ct 0st),0.5379999999999999
145,45,J Vira (VAN),2019-2019,14,14,14,10,4,10,0,3 (3ct 0st),1.0
146,46,LJ Wright (ENG),2007-2014,51,50,14,14,0,0,14,2 (2ct 0st),0.28
147,47,AC Agar (AUS),2016-2019,21,21,13,13,0,0,13,2 (2ct 0st),0.619
148,48,Ahmed Raza (UAE),2014-2019,36,36,13,13,0,0,13,2 (2ct 0st),0.361
149,49,Ahsan Malik (NL),2012-2017,31,30,13,13,0,0,13,2 (2ct 0st),0.433
150,0,TC Bruce (NZ),2017-2019,15,14,13,13,0,1,12,3 (3ct 0st),0.9279999999999999
151,1,MJ Clarke (AUS),2005-2010,34,34,13,13,0,0,13,2 (2ct 0st),0.382
152,2,NM Coulter-Nile (AUS),2013-2019,28,27,13,13,0,0,13,2 (2ct 0st),0.48100000000000004
153,3,JEC Franklin (NZ),2006-2013,38,38,13,13,0,0,13,2 (2ct 0st),0.342
154,4,Liton Das (BDESH),2015-2019,25,25,13,13,0,0,13,2 (2ct 0st),0.52
155,5,JF Mooney (IRE),2009-2015,27,27,13,13,0,0,13,2 (2ct 0st),0.48100000000000004
156,6,MA Ouma (KENYA),2007-2013,22,22,13,8,5,8,0,2 (2ct 0st),0.59
157,7,TD Paine (AUS/World),2009-2017,12,12,13,11,2,11,0,3 (3ct 0st),1.083
158,8,SP Patil (UAE),2014-2016,18,18,13,9,4,9,0,2 (2ct 0st),0.722
159,9,KL Rahul (INDIA),2016-2019,34,34,13,13,0,0,13,2 (2ct 0st),0.382
160,10,Aamir Kaleem (OMAN),2015-2019,25,24,12,12,0,0,12,2 (2ct 0st),0.5
161,11,TA Boult (NZ),2013-2019,27,27,12,12,0,0,12,3 (3ct 0st),0.444
162,12,J Charles (WI),2011-2016,34,34,12,10,2,0,10,2 (2ct 0st),0.35200000000000004
163,13,JH Davey (SCOT),2012-2019,21,20,12,12,0,0,12,2 (2ct 0st),0.6
164,14,CR Ervine (ZIM),2010-2019,22,22,12,12,0,0,12,3 (3ct 0st),0.545
165,15,HG Munsey (SCOT),2015-2019,38,36,12,12,0,0,12,3 (3ct 0st),0.33299999999999996
166,16,Nadeem Ahmed (HKG),2014-2017,24,24,12,12,0,0,12,2 (2ct 0st),0.5
167,17,JDP Oram (NZ),2005-2012,36,36,12,12,0,0,12,2 (2ct 0st),0.33299999999999996
168,18,Saeed Ajmal (PAK),2009-2015,64,64,12,12,0,0,12,2 (2ct 0st),0.187
169,19,MN Samuels (WI),2007-2018,67,67,12,12,0,0,12,2 (2ct 0st),0.179
170,20,TL Seifert (NZ),2018-2019,19,19,12,8,4,8,0,2 (2ct 0st),0.631
171,21,V Sibanda (ZIM),2007-2016,26,26,12,12,0,0,12,3 (3ct 0st),0.461
172,22,Tamoor Sajjad (QAT),2019-2019,12,12,12,12,0,0,12,2 (2ct 0st),1.0
173,23,HA Varaiya (KENYA),2007-2013,25,25,12,12,0,0,12,2 (2ct 0st),0.48
174,24,DJ Willey (ENG),2015-2019,28,28,12,12,0,0,12,2 (2ct 0st),0.428
175,25,Younis Khan (PAK),2006-2010,25,25,12,12,0,0,12,2 (2ct 0st),0.48
176,26,Yuvraj Singh (INDIA),2007-2017,58,57,12,12,0,0,12,2 (2ct 0st),0.21
177,27,A Bagai (CAN),2008-2013,9,9,11,5,6,5,0,2 (1ct 1st),1.222
178,28,S Chandramohan (SGP),2019-2019,12,12,11,11,0,0,11,3 (3ct 0st),0.9159999999999999
179,29,TH David (SGP),2019-2019,12,12,11,11,0,0,11,4 (4ct 0st),0.9159999999999999
180,30,N Davin (NAM),2019-2019,16,16,11,11,0,0,11,3 (3ct 0st),0.687
181,31,JSE Dunford (JER),2019-2019,17,17,11,6,5,6,0,1 (1ct 0st),0.647
182,32,MG Erasmus (NAM),2019-2019,16,16,11,11,0,0,11,2 (2ct 0st),0.687
183,33,JP Faulkner (AUS),2012-2017,24,24,11,11,0,0,11,2 (2ct 0st),0.45799999999999996
184,34,G Gambhir (INDIA),2007-2012,37,36,11,11,0,0,11,2 (2ct 0st),0.305
185,35,Imran Nazir (PAK),2007-2012,25,25,11,11,0,0,11,2 (2ct 0st),0.44
186,36,Jatinder Singh (OMAN),2015-2019,25,25,11,11,0,0,11,2 (2ct 0st),0.44
187,37,Khawar Ali (OMAN),2015-2019,29,28,11,11,0,0,11,2 (2ct 0st),0.392
188,38,Mohammed Rizlan (QAT),2019-2019,15,15,11,8,3,8,0,3 (2ct 1st),0.733
189,39,PL Mommsen (SCOT),2012-2016,24,22,11,11,0,0,11,2 (2ct 0st),0.5
190,40,GD Phillips (NZ),2017-2018,11,10,11,9,2,7,2,4 (3ct 1st),1.1
191,41,Rizwan Cheema (CAN),2008-2019,24,24,11,11,0,0,11,2 (2ct 0st),0.45799999999999996
192,42,Rohan Mustafa (UAE),2014-2019,38,38,11,11,0,0,11,2 (2ct 0st),0.289
193,43,AD Russell (WI),2011-2018,47,47,11,11,0,0,11,2 (2ct 0st),0.23399999999999999
194,44,Shadab Khan (PAK),2017-2019,38,38,11,11,0,0,11,1 (1ct 0st),0.289
195,45,Shaiman Anwar (UAE),2014-2019,32,32,11,11,0,0,11,2 (2ct 0st),0.34299999999999997
196,46,DW Steyn (SA),2007-2019,44,44,11,11,0,0,11,1 (1ct 0st),0.25
197,47,T Taibu (ZIM),2007-2012,17,17,11,6,5,6,0,3 (0ct 3st),0.647
198,48,PA van Meekeren (NL),2013-2019,41,39,11,11,0,0,11,2 (2ct 0st),0.282
199,49,D Weston (GER),2019-2019,6,6,11,9,2,9,0,4 (3ct 1st),1.8330000000000002
200,0,Abdur Razzak (BDESH),2006-2014,34,33,10,10,0,0,10,2 (2ct 0st),0.303
201,1,GJ Bailey (AUS/World),2012-2017,30,30,10,10,0,0,10,2 (2ct 0st),0.33299999999999996
202,2,SJ Benn (WI),2008-2016,24,24,10,10,0,0,10,3 (3ct 0st),0.41600000000000004
203,3,TT Bresnan (ENG),2006-2014,34,34,10,10,0,0,10,2 (2ct 0st),0.294
204,4,RP Burl (ZIM),2018-2019,16,16,10,10,0,0,10,2 (2ct 0st),0.625
205,5,SS Cottrell (WI),2014-2019,22,22,10,10,0,0,10,2 (2ct 0st),0.45399999999999996
206,6,N Dickwella (SL),2016-2019,23,23,10,10,0,9,1,2 (2ct 0st),0.434
207,7,R Escobar (Arg),2019-2019,5,5,10,7,3,7,0,3 (3ct 0st),2.0
208,8,FJ Klaassen (NL),2018-2019,21,20,10,10,0,0,10,2 (2ct 0st),0.5
209,9,Mashrafe Mortaza (BDESH),2006-2017,54,53,10,10,0,0,10,3 (3ct 0st),0.188
210,10,Nizakat Khan (HKG),2014-2019,34,34,10,10,0,0,10,2 (2ct 0st),0.294
211,11,JL Ontong (SA),2008-2015,14,14,10,10,0,0,10,3 (3ct 0st),0.7140000000000001
212,12,RJ Peterson (SA),2006-2014,21,21,10,10,0,0,10,2 (2ct 0st),0.47600000000000003
213,13,AU Rashid (ENG),2009-2019,40,40,10,10,0,0,10,2 (2ct 0st),0.25
214,14,SM Sharif (SCOT),2012-2019,42,41,10,10,0,0,10,2 (2ct 0st),0.243
215,15,JJ Smit (NAM),2019-2019,12,12,10,10,0,0,10,3 (3ct 0st),0.833
216,16,LJ Tucker (IRE),2016-2019,14,14,10,10,0,2,8,2 (2ct 0st),0.7140000000000001
217,17,Usman Ghani (AFG),2015-2019,19,19,10,10,0,0,10,2 (2ct 0st),0.526
218,18,Asif Ali (PAK),2018-2019,25,25,9,9,0,0,9,1 (1ct 0st),0.36
219,19,Mudassar Bukhari (NL),2008-2016,38,36,9,9,0,0,9,2 (2ct 0st),0.25
220,20,CJ Chibhabha (ZIM),2006-2018,33,33,9,9,0,0,9,2 (2ct 0st),0.272
221,21,MD Gunathilaka (SL),2016-2019,21,21,9,9,0,0,9,3 (3ct 0st),0.428
222,22,DT Johnston (IRE),2008-2013,30,28,9,9,0,0,9,3 (3ct 0st),0.321
223,23,Karan KC (NEPAL),2015-2019,25,25,9,9,0,0,9,2 (2ct 0st),0.36
224,24,E Lewis (WI),2016-2019,29,29,9,9,0,0,9,2 (2ct 0st),0.31
225,25,PD McGlashan (NZ),2006-2010,11,11,9,9,0,9,0,3 (3ct 0st),0.818
226,26,Manpreet Singh (ITA),2019-2019,8,7,9,6,3,6,0,4 (3ct 1st),1.285
227,27,Mohamed Azzam (Mald),2019-2019,7,7,9,8,1,8,0,3 (3ct 0st),1.285
228,28,J Mubarak (SL),2007-2009,16,16,9,9,0,0,9,2 (2ct 0st),0.562
229,29,Mustafizur Rahman (BDESH),2015-2019,37,37,9,9,0,0,9,3 (3ct 0st),0.243
230,30,SO Ngoche (KENYA),2010-2019,28,28,9,9,0,0,9,2 (2ct 0st),0.321
231,31,RR Pant (INDIA),2017-2019,26,26,9,6,3,4,2,2 (2ct 0st),0.34600000000000003
232,32,YK Pathan (INDIA),2007-2012,22,22,9,9,0,0,9,2 (2ct 0st),0.409
233,33,R Powell (WI),2017-2019,23,23,9,9,0,0,9,2 (2ct 0st),0.391
234,34,MJ Prior (ENG),2007-2010,10,10,9,6,3,6,0,4 (4ct 0st),0.9
235,35,DMW Rawlins (BMUDA),2019-2019,11,11,9,9,0,0,9,3 (3ct 0st),0.818
236,36,JA Richardson (AUS),2017-2019,9,9,9,9,0,0,9,2 (2ct 0st),1.0
237,37,RR Rossouw (SA),2014-2016,15,15,9,9,0,0,9,3 (3ct 0st),0.6
238,38,CJO Smith (SCOT),2007-2009,8,7,9,5,4,5,0,2 (2ct 0st),1.285
239,39,IS Sodhi (NZ),2014-2019,40,39,9,9,0,0,9,1 (1ct 0st),0.23
240,40,MC Sorensen (IRE),2012-2016,26,24,9,9,0,0,9,2 (2ct 0st),0.375
241,41,BA Stokes (ENG),2011-2018,23,22,9,9,0,0,9,3 (3ct 0st),0.409
242,42,Sultan Ahmed (UAE),2017-2019,17,17,9,9,0,0,9,3 (3ct 0st),0.529
243,43,Suraj Kumar (OMAN),2019-2019,13,13,9,7,2,7,0,2 (2ct 0st),0.6920000000000001
244,44,JE Taylor (WI),2006-2018,30,30,9,9,0,0,9,1 (1ct 0st),0.3
245,45,T van der Gugten (NL),2012-2019,39,38,9,9,0,0,9,2 (2ct 0st),0.23600000000000002
246,46,DL Vettori (NZ),2007-2014,34,34,9,9,0,0,9,2 (2ct 0st),0.264
247,47,CD Wallace (SCOT),2012-2019,19,18,9,7,2,6,1,2 (2ct 0st),0.5
248,48,MN Waller (ZIM),2011-2018,32,32,9,9,0,0,9,1 (1ct 0st),0.281
249,49,D Wiese (SA),2013-2016,20,20,9,9,0,0,9,2 (2ct 0st),0.45
250,0,Zaheer Ibrahim (QAT),2019-2019,13,13,9,9,0,0,9,3 (3ct 0st),0.6920000000000001
251,1,Aizaz Khan (HKG),2014-2019,30,30,8,8,0,0,8,2 (2ct 0st),0.266
252,2,R Ashwin (INDIA),2010-2017,46,46,8,8,0,0,8,1 (1ct 0st),0.17300000000000001
253,3,S Bau (PNG),2016-2019,23,23,8,8,0,0,8,3 (3ct 0st),0.34700000000000003
254,4,DG Blampied (JER),2019-2019,17,17,8,8,0,0,8,2 (2ct 0st),0.47
255,5,AC Botha (IRE),2008-2010,14,13,8,8,0,0,8,2 (2ct 0st),0.615
256,6,JW Dernbach (ENG),2011-2014,34,33,8,8,0,0,8,2 (2ct 0st),0.242
257,7,JN Frylinck (NAM),2019-2019,14,14,8,8,0,0,8,2 (2ct 0st),0.5710000000000001
258,8,HH Gibbs (SA),2005-2010,23,23,8,8,0,0,8,3 (3ct 0st),0.34700000000000003
259,9,RR Hendricks (SA),2014-2019,22,22,8,8,0,0,8,1 (1ct 0st),0.363
260,10,H Klaasen (SA),2018-2019,9,9,8,8,0,5,3,2 (2ct 0st),0.888
261,11,MJ Lumb (ENG),2010-2014,27,26,8,8,0,0,8,1 (1ct 0st),0.307
262,12,BR McDermott (AUS),2018-2019,12,11,8,8,0,0,8,3 (3ct 0st),0.727
263,13,Manpreet Singh (SGP),2019-2019,12,12,8,4,4,4,0,2 (1ct 1st),0.6659999999999999
264,14,KD Mills (NZ),2005-2014,42,42,8,8,0,0,8,1 (1ct 0st),0.19
265,15,DJ Mitchell (NZ),2019-2019,9,9,8,8,0,0,8,2 (2ct 0st),0.888
266,16,Mohammad Nadeem (OMAN),2015-2019,22,22,8,8,0,0,8,3 (3ct 0st),0.363
267,17,M Mosehle (SA),2017-2017,7,7,8,6,2,6,0,3 (2ct 1st),1.1420000000000001
268,18,Nouman Sarwar (QAT),2019-2019,14,14,8,8,0,0,8,2 (2ct 0st),0.5710000000000001
269,19,RT Ponting (AUS),2005-2009,17,17,8,8,0,0,8,2 (2ct 0st),0.47
270,20,Rameez Shahzad (UAE),2016-2019,22,22,8,8,0,0,8,2 (2ct 0st),0.363
271,21,Ravinderpal Singh (CAN),2019-2019,12,12,8,8,0,0,8,2 (2ct 0st),0.6659999999999999
272,22,KW Richardson (AUS),2014-2019,15,15,8,8,0,0,8,2 (2ct 0st),0.5329999999999999
273,23,DJM Short (AUS),2018-2019,20,19,8,8,0,0,8,2 (2ct 0st),0.42100000000000004
274,24,DR Smith (WI),2006-2015,33,33,8,8,0,0,8,1 (1ct 0st),0.242
275,25,Sompal Kami (NEPAL),2014-2019,28,28,8,8,0,0,8,2 (2ct 0st),0.285
276,26,MA Starc (AUS),2012-2019,28,28,8,8,0,0,8,2 (2ct 0st),0.285
277,27,SB Styris (NZ),2005-2010,31,31,8,8,0,0,8,2 (2ct 0st),0.258
278,28,RML Taylor (SCOT),2013-2016,9,9,8,8,0,0,8,2 (2ct 0st),0.888
279,29,HT Tector (IRE),2019-2019,14,14,8,8,0,0,8,2 (2ct 0st),0.5710000000000001
280,30,HDRL Thirimanne (SL),2012-2016,26,26,8,8,0,0,8,1 (1ct 0st),0.307
281,31,AJ Tye (AUS),2016-2018,26,25,8,8,0,0,8,2 (2ct 0st),0.32
282,32,N Vanua (PNG),2015-2019,25,25,8,8,0,0,8,2 (2ct 0st),0.32
283,33,MH Yardy (ENG),2006-2011,14,14,8,8,0,0,8,2 (2ct 0st),0.5710000000000001
284,34,KJ Abbott (SA),2013-2016,21,21,7,7,0,0,7,2 (2ct 0st),0.33299999999999996
285,35,RG Aga (KENYA),2008-2013,20,20,7,7,0,0,7,2 (2ct 0st),0.35
286,36,MM Ali (ENG),2014-2018,25,25,7,7,0,0,7,2 (2ct 0st),0.28
287,37,Aqib Ilyas (OMAN),2015-2019,22,22,7,7,0,0,7,2 (2ct 0st),0.318
288,38,S Badree (WI/World),2012-2018,52,52,7,7,0,0,7,2 (2ct 0st),0.134
289,39,HS Baidwan (CAN),2008-2013,17,17,7,7,0,0,7,2 (2ct 0st),0.41100000000000003
290,40,RD Berrington (SCOT),2008-2019,61,59,7,7,0,0,7,2 (2ct 0st),0.11800000000000001
291,41,Bilal Khan (OMAN),2015-2019,32,31,7,7,0,0,7,2 (2ct 0st),0.225
292,42,RS Bopara (ENG),2008-2014,38,37,7,7,0,0,7,2 (2ct 0st),0.18899999999999997
293,43,DAJ Bracewell (NZ),2011-2019,18,17,7,7,0,0,7,2 (2ct 0st),0.41100000000000003
294,44,YS Chahal (INDIA),2016-2019,36,36,7,7,0,0,7,2 (2ct 0st),0.19399999999999998
295,45,S Chanderpaul (WI),2006-2010,22,22,7,7,0,0,7,1 (1ct 0st),0.318
296,46,MS Chapman (HKG/NZ),2014-2018,24,24,7,7,0,0,7,2 (2ct 0st),0.29100000000000004
297,47,PJ Cummins (AUS),2011-2019,25,25,7,7,0,0,7,1 (1ct 0st),0.28
298,48,AR Cusack (IRE),2008-2015,37,33,7,7,0,0,7,2 (2ct 0st),0.212
299,49,Dawlat Zadran (AFG),2012-2019,34,34,7,7,0,0,7,2 (2ct 0st),0.205
300,0,BR Dunk (AUS),2014-2017,5,5,7,5,2,4,1,3 (1ct 2st),1.4
301,1,AC Evans (SCOT),2015-2019,27,25,7,7,0,0,7,1 (1ct 0st),0.28
302,2,Faheem Ashraf (PAK),2017-2019,27,27,7,7,0,0,7,2 (2ct 0st),0.259
303,3,Fawad Alam (PAK),2007-2010,24,24,7,7,0,0,7,2 (2ct 0st),0.29100000000000004
304,4,Harbhajan Singh (INDIA),2006-2016,28,27,7,7,0,0,7,2 (2ct 0st),0.259
305,5,Hasan Ali (PAK),2016-2019,30,30,7,7,0,0,7,1 (1ct 0st),0.233
306,6,AW Hawkins-Kay (JER),2019-2019,16,16,7,7,0,0,7,2 (2ct 0st),0.43700000000000006
307,7,JO Holder (WI),2014-2019,17,17,7,7,0,0,7,2 (2ct 0st),0.41100000000000003
308,8,Imran Tahir (SA/World),2013-2019,38,38,7,7,0,0,7,2 (2ct 0st),0.184
309,9,Iqbal Hussain (QAT),2019-2019,15,15,7,7,0,0,7,2 (2ct 0st),0.466
310,10,JH Kallis (SA),2005-2012,25,25,7,7,0,0,7,2 (2ct 0st),0.28
311,11,Kuldeep Yadav (INDIA),2017-2019,19,19,7,7,0,0,7,2 (2ct 0st),0.368
312,12,MJ McClenaghan (ICC/NZ),2012-2018,29,29,7,7,0,0,7,1 (1ct 0st),0.24100000000000002
313,13,MW Machan (SCOT),2013-2016,13,13,7,7,0,0,7,1 (1ct 0st),0.5379999999999999
314,14,AD Mascarenhas (ENG),2007-2009,14,14,7,7,0,0,7,2 (2ct 0st),0.5
315,15,Mehidy Hasan Miraz (BDESH),2017-2018,13,13,7,7,0,0,7,2 (2ct 0st),0.5379999999999999
316,16,BMAJ Mendis (SL),2011-2018,22,22,7,7,0,0,7,2 (2ct 0st),0.318
317,17,AK Mohan (Fin),2019-2019,5,5,7,5,2,3,2,3 (2ct 1st),1.4
318,18,PJ Moor (ZIM),2016-2019,21,21,7,7,0,2,5,2 (2ct 0st),0.33299999999999996
319,19,Mosaddek Hossain (BDESH),2016-2019,14,14,7,7,0,0,7,2 (2ct 0st),0.5
320,20,K Motlhanka (Botsw),2019-2019,7,7,7,3,4,3,0,4 (2ct 2st),1.0
321,21,SP Narine (WI),2012-2019,51,51,7,7,0,0,7,2 (2ct 0st),0.13699999999999998
322,22,H Osinde (CAN),2008-2013,11,11,7,7,0,0,7,2 (2ct 0st),0.636
323,23,MK Pandey (INDIA),2015-2019,32,32,7,7,0,0,7,2 (2ct 0st),0.218
324,24,KH Pandya (INDIA),2018-2019,18,18,7,7,0,0,7,2 (2ct 0st),0.38799999999999996
325,25,LE Plunkett (ENG),2006-2019,22,22,7,7,0,0,7,1 (1ct 0st),0.318
326,26,N Pooran (WI),2016-2019,16,16,7,7,0,3,4,2 (2ct 0st),0.43700000000000006
327,27,JD Ryder (NZ),2008-2014,22,22,7,7,0,0,7,2 (2ct 0st),0.318
328,28,RR Sarwan (WI),2007-2010,18,18,7,7,0,0,7,1 (1ct 0st),0.38799999999999996
329,29,MD Shanaka (SL),2015-2019,35,35,7,7,0,0,7,2 (2ct 0st),0.2
330,30,Simi Singh (IRE),2018-2019,18,18,7,7,0,0,7,2 (2ct 0st),0.38799999999999996
331,31,Sohail Tanvir (PAK),2007-2017,57,57,7,7,0,0,7,1 (1ct 0st),0.122
332,32,MP Stoinis (AUS),2015-2019,19,18,7,7,0,0,7,1 (1ct 0st),0.38799999999999996
333,33,MR Swart (NL),2012-2016,26,26,7,7,0,0,7,1 (1ct 0st),0.26899999999999996
334,34,R Tari (VAN),2019-2019,14,14,7,7,0,0,7,2 (2ct 0st),0.5
335,35,TP Ura (PNG),2015-2019,23,23,7,7,0,0,7,2 (2ct 0st),0.304
336,36,Waqas Barkat (HKG),2014-2019,22,22,7,7,0,0,7,2 (2ct 0st),0.318
337,37,MRJ Watt (SCOT),2015-2019,35,33,7,7,0,0,7,1 (1ct 0st),0.212
338,38,KOK Williams (WI),2016-2019,24,24,7,7,0,0,7,1 (1ct 0st),0.29100000000000004
339,39,Yasir Ali (ESP),2019-2019,9,9,7,7,0,0,7,2 (2ct 0st),0.777
340,40,CA Young (IRE),2015-2019,26,25,7,7,0,0,7,2 (2ct 0st),0.28
341,41,Abdur Rehman (PAK),2007-2013,8,8,6,6,0,0,6,2 (2ct 0st),0.75
342,42,DS Airee (NEPAL),2018-2019,18,18,6,6,0,0,6,1 (1ct 0st),0.33299999999999996
343,43,PS Airee (NEPAL),2015-2019,11,11,6,5,1,3,2,2 (2ct 0st),0.545
344,44,Anshuman Rath (HKG),2015-2017,20,20,6,6,0,0,6,1 (1ct 0st),0.3
345,45,Awais Ahmed (ESP),2019-2019,9,9,6,5,1,5,0,1 (1ct 0st),0.6659999999999999
346,46,NW Bracken (AUS),2006-2009,19,19,6,6,0,0,6,1 (1ct 0st),0.315
347,47,JJ Bumrah (INDIA),2016-2019,42,42,6,6,0,0,6,2 (2ct 0st),0.142
348,48,PVD Chameera (SL),2015-2018,19,19,6,6,0,0,6,2 (2ct 0st),0.315
349,49,TLW Cooper (NL),2012-2016,18,17,6,6,0,0,6,2 (2ct 0st),0.35200000000000004
350,0,FA Cossa (Moz),2019-2019,6,5,6,6,0,0,6,3 (3ct 0st),1.2
351,1,AG Cremer (ZIM),2008-2018,29,29,6,6,0,0,6,1 (1ct 0st),0.20600000000000002
352,2,ST Finn (ENG),2011-2015,21,21,6,6,0,0,6,1 (1ct 0st),0.285
353,3,JS Foster (ENG),2009-2009,5,5,6,3,3,3,0,2 (1ct 1st),1.2
354,4,SO Hetmyer (WI),2018-2019,20,20,6,6,0,0,6,2 (2ct 0st),0.3
355,5,SD Hope (WI),2017-2019,13,13,6,6,0,6,0,2 (2ct 0st),0.461
356,6,GJ Hopkins (NZ),2007-2010,10,10,6,4,2,2,2,2 (2ct 0st),0.6
357,7,Imran Ismail (Moz),2019-2019,7,6,6,6,0,5,1,2 (2ct 0st),1.0
358,8,Janak Prakash (SGP),2019-2019,12,12,6,6,0,0,6,3 (3ct 0st),0.5
359,9,Kamran Khan (QAT),2019-2019,14,14,6,6,0,0,6,2 (2ct 0st),0.428
360,10,Karim Sadiq (AFG),2010-2018,36,36,6,6,0,0,6,1 (1ct 0st),0.166
361,11,B Kumar (INDIA),2012-2019,43,43,6,6,0,0,6,1 (1ct 0st),0.139
362,12,ND Laegsgaard (DEN),2019-2019,9,7,6,6,0,0,6,3 (3ct 0st),0.857
363,13,TWM Latham (NZ),2012-2017,13,13,6,6,0,4,2,3 (3ct 0st),0.461
364,14,B Lee (AUS),2005-2012,25,25,6,6,0,0,6,3 (3ct 0st),0.24
365,15,AR McBrine (IRE),2014-2017,19,18,6,6,0,0,6,2 (2ct 0st),0.33299999999999996
366,16,PK Matautaava (VAN),2019-2019,10,10,6,6,0,0,6,3 (3ct 0st),0.6
367,17,BAW Mendis (SL),2008-2014,39,39,6,6,0,0,6,1 (1ct 0st),0.153
368,18,BKG Mendis (SL),2016-2019,24,24,6,6,0,0,6,1 (1ct 0st),0.25
369,19,Mohammad Nawaz (3) (PAK),2016-2018,16,16,6,6,0,0,6,1 (1ct 0st),0.375
370,20,CH Morris (SA),2012-2019,23,23,6,6,0,0,6,2 (2ct 0st),0.26
371,21,Muhammad Usman (UAE),2016-2019,34,34,6,6,0,0,6,1 (1ct 0st),0.17600000000000002
372,22,Nasir Jamshed (PAK),2012-2013,18,18,6,6,0,0,6,2 (2ct 0st),0.33299999999999996
373,23,AR Nurse (WI),2011-2019,13,13,6,6,0,0,6,2 (2ct 0st),0.461
374,24,Nurul Hasan (BDESH),2016-2017,9,9,6,2,4,2,0,2 (0ct 2st),0.6659999999999999
375,25,NN Odhiambo (KENYA),2007-2013,24,24,6,6,0,0,6,1 (1ct 0st),0.25
376,26,HH Patel (MWI),2019-2019,7,7,6,6,0,0,6,2 (2ct 0st),0.857
377,27,CW Perchard (JER),2019-2019,15,15,6,6,0,0,6,1 (1ct 0st),0.4
378,28,BBJL Perera (ITA),2019-2019,8,7,6,6,0,0,6,3 (3ct 0st),0.857
379,29,AL Phehlukwayo (SA),2017-2019,23,23,6,6,0,0,6,2 (2ct 0st),0.26
380,30,Rehman Abdul (ITA),2019-2019,7,6,6,6,0,0,6,2 (2ct 0st),1.0
381,31,S Samarawickrama (SL),2017-2019,7,7,6,4,2,3,1,2 (1ct 1st),0.857
382,32,Shafraz Jaleel (Mald),2019-2019,4,4,6,4,2,4,0,3 (3ct 0st),1.5
383,33,HAM Shah (DEN),2019-2019,9,7,6,6,0,0,6,3 (3ct 0st),0.857
384,34,TAM Siriwardana (SL),2015-2017,22,22,6,6,0,0,6,2 (2ct 0st),0.272
385,35,P Utseya (ZIM),2006-2015,35,35,6,6,0,0,6,1 (1ct 0st),0.171
386,36,MN van Wyk (SA),2007-2015,8,8,6,5,1,3,2,1 (1ct 0st),0.75
387,37,JNT Vare (PNG),2015-2017,8,8,6,4,2,4,0,3 (3ct 0st),0.75
388,38,S Vesawkar (NEPAL),2014-2019,17,17,6,6,0,0,6,1 (1ct 0st),0.35200000000000004
389,39,Virandeep Singh (MAL),2019-2019,12,12,6,6,0,0,6,2 (2ct 0st),0.5
390,40,DF Watts (SCOT),2007-2012,11,10,6,6,0,0,6,3 (3ct 0st),0.6
391,41,Zeeshan Maqsood (OMAN),2015-2019,29,28,6,6,0,0,6,2 (2ct 0st),0.214
392,42,Aarif Sheikh (NEPAL),2018-2019,11,11,5,5,0,0,5,1 (1ct 0st),0.45399999999999996
393,43,Adnan Ilyas (OMAN),2015-2016,12,11,5,5,0,0,5,3 (3ct 0st),0.45399999999999996
394,44,KK Ahuja (Mex),2019-2019,8,8,5,2,3,1,1,2 (0ct 2st),0.625
395,45,CJA Amini (PNG),2015-2019,23,23,5,5,0,0,5,1 (1ct 0st),0.217
396,46,Anwar Ali (PAK),2008-2016,16,16,5,5,0,0,5,2 (2ct 0st),0.312
397,47,Ariful Haque (BDESH),2018-2018,9,9,5,5,0,0,5,1 (1ct 0st),0.555
398,48,SJ Baard (NAM),2019-2019,13,13,5,5,0,0,5,2 (2ct 0st),0.384
399,49,O Bascome (BMUDA),2019-2019,11,11,5,4,1,2,2,2 (2ct 0st),0.45399999999999996
400,0,PKD Chase (IRE),2018-2019,12,12,5,5,0,0,5,2 (2ct 0st),0.41600000000000004
401,1,DT Christian (AUS),2010-2017,16,16,5,5,0,0,5,2 (2ct 0st),0.312
402,2,BCJ Cutting (AUS/World),2013-2017,7,7,5,5,0,0,5,3 (3ct 0st),0.7140000000000001
403,3,MD Dai (PNG),2015-2017,9,9,5,5,0,0,5,2 (2ct 0st),0.555
404,4,A Dananjaya (SL),2012-2019,22,22,5,5,0,0,5,1 (1ct 0st),0.22699999999999998
405,5,GJ Delany (IRE),2019-2019,17,17,5,5,0,0,5,2 (2ct 0st),0.294
406,6,NS Dhaliwal (CAN),2019-2019,12,12,5,5,0,0,5,1 (1ct 0st),0.41600000000000004
407,7,AC Douglas (BMUDA),2019-2019,10,10,5,5,0,0,5,3 (3ct 0st),0.5
408,8,FH Edwards (WI),2007-2012,20,20,5,5,0,0,5,1 (1ct 0st),0.25
409,9,Fahad Ali (),2019-2019,3,3,5,4,1,2,2,3 (2ct 1st),1.666
410,10,Faisal Javed (QAT),2019-2019,15,15,5,5,0,0,5,1 (1ct 0st),0.33299999999999996
411,11,LB Ferbrache (GUE),2019-2019,9,9,5,5,0,0,5,1 (1ct 0st),0.555
412,12,A Flintoff (ENG),2005-2007,7,7,5,5,0,0,5,2 (2ct 0st),0.7140000000000001
413,13,DM Gondaria (KENYA),2013-2019,11,11,5,5,0,0,5,1 (1ct 0st),0.45399999999999996
414,14,NA Greenwood (JER),2019-2019,8,8,5,5,0,0,5,3 (3ct 0st),0.625
415,15,DAS Gunaratne (SL),2016-2017,12,12,5,5,0,0,5,2 (2ct 0st),0.41600000000000004
416,16,S Hallett (Peru),2019-2019,4,4,5,4,1,4,0,3 (3ct 0st),1.25
417,17,Hilal Ahmad (CZK-R),2019-2019,7,7,5,5,0,5,0,3 (3ct 0st),0.7140000000000001
418,18,BJ Hodge (AUS),2007-2014,15,15,5,5,0,0,5,1 (1ct 0st),0.33299999999999996
419,19,Ibrahim Hassan (Mald),2019-2019,11,11,5,5,0,0,5,2 (2ct 0st),0.45399999999999996
420,20,Jagjit Singh (Peru),2019-2019,4,4,5,5,0,0,5,3 (3ct 0st),1.25
421,21,KM Jarvis (ZIM),2011-2019,22,22,5,5,0,0,5,1 (1ct 0st),0.22699999999999998
422,22,MG Johnson (AUS),2007-2013,30,30,5,5,0,0,5,1 (1ct 0st),0.166
423,23,EC Joyce (ENG/IRE),2006-2014,18,17,5,5,0,0,5,2 (2ct 0st),0.294
424,24,Junaid Sheikh (NOR),2019-2019,5,5,5,5,0,0,5,2 (2ct 0st),1.0
425,25,D Kansonkho (MWI),2019-2019,7,7,5,5,0,0,5,2 (2ct 0st),0.7140000000000001
426,26,Karim Janat (AFG),2016-2019,21,21,5,5,0,0,5,2 (2ct 0st),0.23800000000000002
427,27,SP Khakurel (NEPAL),2014-2015,8,8,5,2,3,2,0,2 (0ct 2st),0.625
428,28,UT Khawaja (AUS),2016-2016,9,9,5,5,0,0,5,1 (1ct 0st),0.555
429,29,JP Kotze (NAM),2019-2019,12,12,5,5,0,0,5,2 (2ct 0st),0.41600000000000004
430,30,HG Kuhn (SA),2009-2017,7,7,5,5,0,4,1,3 (3ct 0st),0.7140000000000001
431,31,NR Kumar (CAN),2012-2019,18,18,5,5,0,0,5,2 (2ct 0st),0.27699999999999997
432,32,AV Lalcheta (OMAN),2015-2019,17,16,5,5,0,0,5,2 (2ct 0st),0.312
433,33,JS Malhotra (USA),2019-2019,6,6,5,2,3,2,0,2 (0ct 2st),0.833
434,34,A Mansale (VAN),2019-2019,14,14,5,5,0,0,5,2 (2ct 0st),0.35700000000000004
435,35,T Maruma (ZIM),2008-2019,13,13,5,5,0,0,5,1 (1ct 0st),0.384
436,36,S Matsikenyeri (ZIM),2006-2012,10,10,5,5,0,0,5,2 (2ct 0st),0.5
437,37,SS McKechnie (HKG),2019-2019,10,10,5,4,1,4,0,2 (2ct 0st),0.5
438,38,EJB Miles (JER),2019-2019,14,14,5,5,0,0,5,2 (2ct 0st),0.35700000000000004
439,39,AF Milne (NZ),2010-2018,21,21,5,5,0,0,5,1 (1ct 0st),0.23800000000000002
440,40,Mirwais Ashraf (AFG),2010-2016,25,25,5,5,0,0,5,1 (1ct 0st),0.2
441,41,Mohammad Rizwan (PAK),2015-2019,16,16,5,3,2,3,0,2 (2ct 0st),0.312
442,42,Mohammed Nadeem (QAT),2019-2019,15,15,5,5,0,0,5,2 (2ct 0st),0.33299999999999996
443,43,M Morkel (SA/World),2007-2017,44,44,5,5,0,0,5,1 (1ct 0st),0.113
444,44,CB Mpofu (ZIM),2008-2019,30,30,5,5,0,0,5,2 (2ct 0st),0.166
445,45,Muhammad Tanveer (QAT),2019-2019,15,15,5,5,0,0,5,2 (2ct 0st),0.33299999999999996
446,46,S Muniandy (MAL),2019-2019,15,14,5,5,0,0,5,3 (3ct 0st),0.35700000000000004
447,47,C Munoz-Mills (ESP),2019-2019,9,9,5,5,0,0,5,2 (2ct 0st),0.555
448,48,SJ Myburgh (NL),2012-2019,33,32,5,5,0,0,5,1 (1ct 0st),0.156
449,49,JDS Neesham (NZ),2012-2019,18,18,5,5,0,0,5,2 (2ct 0st),0.27699999999999997
450,0,R Nehonde (Botsw),2019-2019,7,7,5,5,0,0,5,3 (3ct 0st),0.7140000000000001
451,1,OE Newey (GUE),2019-2019,7,7,5,4,1,4,0,2 (2ct 0st),0.7140000000000001
452,2,RJ Nicol (NZ),2010-2013,21,21,5,5,0,0,5,2 (2ct 0st),0.23800000000000002
453,3,NM Odhiambo (KENYA),2010-2019,16,16,5,5,0,0,5,2 (2ct 0st),0.312
454,4,TM Odoyo (KENYA),2007-2013,11,11,5,5,0,0,5,2 (2ct 0st),0.45399999999999996
455,5,CN Onwuzulike (NGA),2019-2019,9,9,5,5,0,0,5,3 (3ct 0st),0.555
456,6,R Panchal (ESP),2019-2019,9,9,5,5,0,0,5,2 (2ct 0st),0.555
457,7,WD Parnell (SA),2009-2017,40,40,5,5,0,0,5,1 (1ct 0st),0.125
458,8,AR Patel (INDIA),2015-2018,11,11,5,5,0,0,5,2 (2ct 0st),0.45399999999999996
459,9,MD Patel (USA),2019-2019,8,8,5,3,2,1,2,2 (1ct 1st),0.625
460,10,NK Patel (USA),2019-2019,4,4,5,5,0,0,5,2 (2ct 0st),1.25
461,11,Rahmanullah Gurbaz (AFG),2019-2019,7,7,5,4,1,4,0,2 (1ct 1st),0.7140000000000001
462,12,J Rasu (VAN),2019-2019,13,13,5,5,0,0,5,1 (1ct 0st),0.384
463,13,D Ravu (PNG),2019-2019,17,17,5,5,0,0,5,1 (1ct 0st),0.294
464,14,JJ Roy (ENG),2014-2018,32,32,5,5,0,0,5,1 (1ct 0st),0.156
465,15,Sami Sohail (MWI),2019-2019,7,7,5,5,0,0,5,2 (2ct 0st),0.7140000000000001
466,16,Sandeep Goud (OMAN),2019-2019,12,12,5,5,0,0,5,2 (2ct 0st),0.41600000000000004
467,17,E Schiferli (NL),2008-2010,7,6,5,5,0,0,5,1 (1ct 0st),0.833
468,18,Shafiq Sharif (MAL),2019-2019,10,9,5,2,3,2,0,2 (2ct 0st),0.555
469,19,KD Shah (HKG),2014-2019,26,26,5,5,0,0,5,2 (2ct 0st),0.192
470,20,OA Shah (ENG),2007-2009,17,17,5,5,0,0,5,2 (2ct 0st),0.294
471,21,Shapoor Zadran (AFG),2010-2018,34,34,5,5,0,0,5,1 (1ct 0st),0.147
472,22,Sharjeel Khan (PAK),2013-2016,15,15,5,5,0,0,5,2 (2ct 0st),0.33299999999999996
473,23,RJ Sidebottom (ENG),2007-2010,18,18,5,5,0,0,5,2 (2ct 0st),0.27699999999999997
474,24,LPC Silva (SL),2006-2011,16,16,5,5,0,0,5,1 (1ct 0st),0.312
475,25,TB Sole (SCOT),2019-2019,9,9,5,5,0,0,5,1 (1ct 0st),0.555
476,26,GP Swann (ENG),2008-2012,39,39,5,5,0,0,5,1 (1ct 0st),0.128
477,27,SR Taylor (USA),2019-2019,8,8,5,5,0,0,5,2 (2ct 0st),0.625
478,28,SO Tikolo (KENYA),2007-2013,15,15,5,5,0,0,5,2 (2ct 0st),0.33299999999999996
479,29,AJ Turner (AUS),2017-2019,11,11,5,5,0,0,5,1 (1ct 0st),0.45399999999999996
480,30,C Viljoen (NAM),2019-2019,12,12,5,5,0,0,5,1 (1ct 0st),0.41600000000000004
481,31,JM Vince (ENG),2015-2019,12,12,5,5,0,0,5,2 (2ct 0st),0.41600000000000004
482,32,Wahab Riaz (PAK),2008-2019,31,31,5,5,0,0,5,1 (1ct 0st),0.161
483,33,B Ward (JER),2019-2019,13,13,5,5,0,0,5,1 (1ct 0st),0.384
484,34,Washington Sundar (INDIA),2017-2019,18,18,5,5,0,0,5,1 (1ct 0st),0.27699999999999997
485,35,Abdul-Shakoor Rahimzei (GER),2019-2019,7,7,4,4,0,0,4,2 (2ct 0st),0.5710000000000001
486,36,CN Ackermann (NL),2019-2019,11,11,4,4,0,0,4,1 (1ct 0st),0.363
487,37,Adnan Idrees (KUW),2019-2019,6,6,4,4,0,0,4,1 (1ct 0st),0.6659999999999999
488,38,Aftab Ahmed (BDESH),2006-2010,11,11,4,4,0,0,4,2 (2ct 0st),0.363
489,39,FA Allen (WI),2018-2019,11,11,4,4,0,0,4,2 (2ct 0st),0.363
490,40,Amjad Javed (UAE),2014-2017,22,22,4,4,0,0,4,1 (1ct 0st),0.18100000000000002
491,41,SE Aquilina (MALTA),2019-2019,4,4,4,0,4,0,0,2 (0ct 2st),1.0
492,42,Asad Mohammad (GER),2019-2019,9,9,4,4,0,0,4,1 (1ct 0st),0.444
493,43,MA Baig (MWI),2019-2019,7,7,4,4,0,0,4,3 (3ct 0st),0.5710000000000001
494,44,B Banerjee (Mex),2019-2019,6,6,4,4,0,3,1,1 (1ct 0st),0.6659999999999999
495,45,T Banton (ENG),2019-2019,3,3,4,4,0,0,4,2 (2ct 0st),1.3330000000000002
496,46,JP Behrendorff (AUS),2017-2019,7,6,4,4,0,0,4,3 (3ct 0st),0.6659999999999999
497,47,IR Bell (ENG),2006-2014,8,8,4,4,0,0,4,1 (1ct 0st),0.5
498,48,TS Bharaj (DEN),2019-2019,9,7,4,4,0,0,4,3 (3ct 0st),0.5710000000000001
499,49,Meet Bhavsar (KUW),2019-2019,9,9,4,4,0,4,0,3 (3ct 0st),0.444
500,0,MP Biddappa (PHI),2019-2019,4,4,4,3,1,3,0,2 (2ct 0st),1.0
501,1,Bilal Tahir (KUW),2019-2019,4,4,4,4,0,0,4,1 (1ct 0st),1.0
502,2,Bilal Zalmai (Aut),2019-2019,5,5,4,3,1,0,3,2 (2ct 0st),0.8
503,3,PRP Boissevain (NL),2019-2019,4,4,4,4,0,0,4,2 (2ct 0st),1.0
504,4,SE Bond (NZ),2005-2010,20,20,4,4,0,0,4,1 (1ct 0st),0.2
505,5,DM Bravo (WI),2010-2019,20,20,4,4,0,0,4,2 (2ct 0st),0.2
506,6,NT Broom (NZ),2009-2017,11,11,4,4,0,0,4,1 (1ct 0st),0.363
507,7,DE Budge (SCOT),2018-2018,6,6,4,4,0,0,4,1 (1ct 0st),0.6659999999999999
508,8,RW Chakabva (ZIM),2008-2019,12,12,4,4,0,0,4,1 (1ct 0st),0.33299999999999996
509,9,TL Chatara (ZIM),2010-2019,21,21,4,4,0,0,4,1 (1ct 0st),0.19
510,10,JW Chilia (VAN),2019-2019,14,14,4,4,0,0,4,2 (2ct 0st),0.285
511,11,K Christie (HKG),2019-2019,11,11,4,4,0,0,4,1 (1ct 0st),0.363
512,12,SR Clark (AUS),2006-2007,9,9,4,4,0,0,4,1 (1ct 0st),0.444
513,13,DDP D'Silva (UAE),2019-2019,10,10,4,4,0,0,4,1 (1ct 0st),0.4
514,14,DAP Darrell (BMUDA),2019-2019,11,11,4,4,0,0,4,2 (2ct 0st),0.363
515,15,TN de Grooth (NL),2008-2013,15,14,4,4,0,0,4,2 (2ct 0st),0.285
516,16,DM de Silva (SL),2015-2019,13,13,4,4,0,0,4,1 (1ct 0st),0.307
517,17,PWH de Silva (SL),2019-2019,8,8,4,4,0,0,4,1 (1ct 0st),0.5
518,18,S Dhaniram (CAN),2008-2010,11,11,4,4,0,0,4,2 (2ct 0st),0.363
519,19,S Dube (INDIA),2019-2019,6,6,4,4,0,0,4,2 (2ct 0st),0.6659999999999999
520,20,Ehsan Khan (HKG),2016-2019,15,15,4,4,0,0,4,1 (1ct 0st),0.266
521,21,Elias Sunny (BDESH),2012-2012,7,7,4,4,0,0,4,3 (3ct 0st),0.5710000000000001
522,22,GD Elliott (NZ/World),2009-2017,17,17,4,4,0,0,4,2 (2ct 0st),0.235
523,23,Fahad Tariq (UAE),2016-2016,6,6,4,4,0,0,4,3 (3ct 0st),0.6659999999999999
524,24,Farhad Reza (BDESH),2006-2014,13,13,4,4,0,0,4,1 (1ct 0st),0.307
525,25,O Fournier (CRC),2019-2019,2,2,4,4,0,0,4,2 (2ct 0st),2.0
526,26,PG Fulton (NZ),2006-2012,12,12,4,4,0,0,4,1 (1ct 0st),0.33299999999999996
527,27,PF Gallagher (Fin),2019-2019,3,3,4,4,0,0,4,2 (2ct 0st),1.3330000000000002
528,28,G Goudie (SCOT),2010-2013,9,9,4,4,0,0,4,1 (1ct 0st),0.444
529,29,TGJ Gruijters (NL),2012-2013,8,8,4,4,0,0,4,2 (2ct 0st),0.5
530,30,K Gupta (Chile),2019-2019,4,4,4,3,1,3,0,3 (2ct 1st),1.0
531,31,OD Hald (DEN),2019-2019,9,7,4,4,0,0,4,2 (2ct 0st),0.5710000000000001
532,32,Hamza Tahir (SCOT),2018-2019,11,11,4,4,0,0,4,1 (1ct 0st),0.363
533,33,RM Haq (SCOT),2007-2013,21,20,4,4,0,0,4,2 (2ct 0st),0.2
534,34,TM Head (AUS),2016-2018,16,16,4,4,0,0,4,1 (1ct 0st),0.25
535,35,R Hekure (PNG),2019-2019,8,8,4,4,0,0,4,2 (2ct 0st),0.5
536,36,DR Hooper (GUE),2019-2019,9,9,4,4,0,0,4,2 (2ct 0st),0.444
537,37,Hussain Talat (PAK),2018-2019,14,14,4,4,0,0,4,3 (3ct 0st),0.285
538,38,DP Hyatt (WI),2011-2012,5,5,4,4,0,0,4,1 (1ct 0st),0.8
539,39,Imran Haider (ROM),2019-2019,2,2,4,2,2,2,0,3 (2ct 1st),2.0
540,40,Imrul Kayes (BDESH),2010-2017,14,14,4,4,0,0,4,1 (1ct 0st),0.285
541,41,SS Iyer (INDIA),2017-2019,14,14,4,4,0,0,4,1 (1ct 0st),0.285
542,42,ST Jayasuriya (SL),2006-2011,31,31,4,4,0,0,4,1 (1ct 0st),0.129
543,43,LM Jongwe (ZIM),2015-2016,8,8,4,4,0,0,4,2 (2ct 0st),0.5
544,44,SHT Kandamby (SL),2008-2011,5,5,4,4,0,0,4,2 (2ct 0st),0.8
545,45,G Kansonkho (MWI),2019-2019,6,6,4,4,0,0,4,2 (2ct 0st),0.6659999999999999
546,46,AN Kervezee (NL),2009-2012,10,10,4,4,0,0,4,2 (2ct 0st),0.4
547,47,Khalid Latif (PAK),2008-2016,13,13,4,4,0,0,4,1 (1ct 0st),0.307
548,48,BA King (WI),2019-2019,6,6,4,4,0,0,4,1 (1ct 0st),0.6659999999999999
549,49,EB Knowles (CZK-R),2019-2019,7,7,4,4,0,0,4,4 (4ct 0st),0.5710000000000001
550,0,SC Kuggeleijn (NZ),2019-2019,9,9,4,4,0,0,4,2 (2ct 0st),0.444
551,1,Kuldeep Lal (ESP),2019-2019,8,8,4,4,0,0,4,2 (2ct 0st),0.5
552,2,RE Levi (SA),2012-2012,13,13,4,4,0,0,4,1 (1ct 0st),0.307
553,3,N Madziva (ZIM),2015-2019,15,15,4,4,0,0,4,1 (1ct 0st),0.266
554,4,MSS Mandy (Chile),2019-2019,4,4,4,4,0,0,4,1 (1ct 0st),1.0
555,5,MR Marsh (AUS),2011-2018,11,11,4,4,0,0,4,2 (2ct 0st),0.363
556,6,XM Marshall (USA/WI),2008-2019,13,13,4,4,0,0,4,1 (1ct 0st),0.307
557,7,WP Masakadza (ZIM),2015-2019,12,12,4,4,0,0,4,2 (2ct 0st),0.33299999999999996
558,8,Md Nurul Huda (Fin),2019-2019,5,5,4,4,0,0,4,2 (2ct 0st),0.8
559,9,AS Mehmi (),2019-2019,3,3,4,4,0,0,4,2 (2ct 0st),1.3330000000000002
560,10,Mohammad Amir (PAK),2009-2019,48,48,4,4,0,0,4,1 (1ct 0st),0.083
561,11,Mohammad Ashraful (BDESH),2007-2013,23,23,4,4,0,0,4,1 (1ct 0st),0.17300000000000001
562,12,Mohammad Boota (UAE),2019-2019,16,16,4,3,1,2,1,2 (1ct 1st),0.25
563,13,Mohammad Naveed (UAE),2015-2019,31,31,4,4,0,0,4,1 (1ct 0st),0.129
564,14,Muhammad Awais (),2019-2019,3,3,4,3,1,3,0,3 (2ct 1st),1.3330000000000002
565,15,GRD Munasinghe (ITA),2019-2019,8,7,4,4,0,0,4,1 (1ct 0st),0.5710000000000001
566,16,A Nehra (INDIA),2009-2017,27,27,4,4,0,0,4,1 (1ct 0st),0.14800000000000002
567,17,A Neill (SCOT),2019-2019,5,5,4,4,0,0,4,2 (2ct 0st),0.8
568,18,SN Netravalkar (USA),2019-2019,8,8,4,4,0,0,4,1 (1ct 0st),0.5
569,19,N Nipiko (VAN),2019-2019,14,14,4,4,0,0,4,1 (1ct 0st),0.285
570,20,Noor Ali Zadran (AFG),2010-2017,20,20,4,4,0,0,4,1 (1ct 0st),0.2
571,21,AA Obanda (KENYA),2007-2019,30,30,4,4,0,0,4,1 (1ct 0st),0.133
572,22,JS Patel (NZ),2005-2008,11,11,4,4,0,0,4,1 (1ct 0st),0.363
573,23,RK Paudel (NEPAL),2019-2019,11,11,4,4,0,0,4,2 (2ct 0st),0.363
574,24,N Pokana (PNG),2016-2019,19,19,4,4,0,0,4,2 (2ct 0st),0.21
575,25,S Prasanna (SL),2013-2017,20,20,4,4,0,0,4,2 (2ct 0st),0.2
576,26,AT Rayudu (INDIA),2014-2016,6,6,4,4,0,0,4,2 (2ct 0st),0.6659999999999999
577,27,B Regmi (NEPAL),2014-2019,18,18,4,4,0,0,4,1 (1ct 0st),0.222
578,28,MJ Richardson (GER),2019-2019,3,3,4,1,3,1,0,2 (1ct 1st),1.3330000000000002
579,29,MJG Rippon (NL),2013-2018,18,17,4,4,0,0,4,1 (1ct 0st),0.235
580,30,PADLR Sandakan (SL),2017-2019,14,14,4,4,0,0,4,1 (1ct 0st),0.285
581,31,Saqlain Haider (UAE),2016-2016,6,6,4,4,0,0,4,2 (2ct 0st),0.6659999999999999
582,32,T Shamsi (SA),2017-2019,16,16,4,4,0,0,4,1 (1ct 0st),0.25
583,33,I Sharma (INDIA),2008-2013,14,14,4,4,0,0,4,1 (1ct 0st),0.285
584,34,B Shikongo (NAM),2019-2019,11,11,4,4,0,0,4,1 (1ct 0st),0.363
585,35,Sikander Zulfiqar (NL),2016-2019,11,11,4,4,0,0,4,2 (2ct 0st),0.363
586,36,Simandeep Singh (HKG),2019-2019,7,7,4,4,0,0,4,2 (2ct 0st),0.5710000000000001
587,37,Sohaib Maqsood (PAK),2013-2016,20,20,4,4,0,0,4,1 (1ct 0st),0.2
588,38,ES Szwarczynski (NL),2008-2013,14,13,4,4,0,0,4,2 (2ct 0st),0.307
589,39,Tanwir Afzal (HKG),2014-2016,21,21,4,4,0,0,4,1 (1ct 0st),0.19
590,40,RN ten Doeschate (NL),2008-2019,22,21,4,4,0,0,4,1 (1ct 0st),0.19
591,41,C Tommy (VAN),2019-2019,12,12,4,4,0,0,4,1 (1ct 0st),0.33299999999999996
592,42,I Udana (SL),2009-2019,27,27,4,4,0,0,4,2 (2ct 0st),0.14800000000000002
593,43,Umar Amin (PAK),2013-2018,14,14,4,4,0,0,4,1 (1ct 0st),0.285
594,44,DLS van Bunge (NL),2008-2013,14,13,4,4,0,0,4,2 (2ct 0st),0.307
595,45,RR Watson (SCOT),2007-2010,10,9,4,4,0,0,4,2 (2ct 0st),0.444
596,46,K Weeraratne (SL),2008-2009,5,5,4,4,0,0,4,2 (2ct 0st),0.8
597,47,Yasir Shah (PAK),2011-2011,2,2,4,4,0,0,4,3 (3ct 0st),2.0
598,48,Ziaur Rahman (BDESH),2012-2014,14,14,4,4,0,0,4,2 (2ct 0st),0.285
599,49,MR Adair (IRE),2019-2019,17,17,3,3,0,0,3,1 (1ct 0st),0.17600000000000002
600,0,S Adedeji (NGA),2019-2019,6,6,3,3,0,0,3,1 (1ct 0st),0.5
601,1,Afif Hossain (BDESH),2018-2019,8,8,3,3,0,0,3,1 (1ct 0st),0.375
602,2,Aftab Alam (AFG),2012-2018,12,12,3,3,0,0,3,2 (2ct 0st),0.25
603,3,KK Ahmed (INDIA),2018-2019,14,14,3,3,0,0,3,1 (1ct 0st),0.214
604,4,Ainool Haqqiem (MAL),2019-2019,4,4,3,1,2,1,0,2 (0ct 2st),0.75
605,5,TP Allen (USA),2019-2019,5,5,3,3,0,0,3,1 (1ct 0st),0.6
606,6,Al-Amin Hossain (BDESH),2013-2019,28,26,3,3,0,0,3,1 (1ct 0st),0.115
607,7,Amir Mangal (GER),2019-2019,9,9,3,3,0,0,3,2 (2ct 0st),0.33299999999999996
608,8,JM Anderson (ENG),2007-2009,19,19,3,3,0,0,3,1 (1ct 0st),0.157
609,9,Anowarul Islam (THAI),2019-2019,4,4,3,3,0,0,3,2 (2ct 0st),0.75
610,10,P Arrighi (Arg),2019-2019,5,5,3,3,0,0,3,2 (2ct 0st),0.6
611,11,Asad Shafiq (PAK),2010-2012,10,10,3,3,0,0,3,1 (1ct 0st),0.3
612,12,NJ Astle (NZ),2005-2006,4,4,3,3,0,0,3,2 (2ct 0st),0.75
613,13,TD Astle (NZ),2016-2019,3,3,3,3,0,0,3,1 (1ct 0st),1.0
614,14,AJ Ayannaike (NGA),2019-2019,3,3,3,2,1,2,0,3 (2ct 1st),1.0
615,15,F Baaleri (Ghana),2019-2019,4,4,3,3,0,1,2,2 (2ct 0st),0.75
616,16,Babar Ali (BAH),2019-2019,3,3,3,3,0,0,3,1 (1ct 0st),1.0
617,17,V Balakrishnan (Botsw),2019-2019,3,3,3,3,0,0,3,3 (3ct 0st),1.0
618,18,OGL Bascome (BMUDA),2019-2019,11,11,3,3,0,0,3,1 (1ct 0st),0.272
619,19,V Baskaran (SGP),2019-2019,12,12,3,3,0,0,3,1 (1ct 0st),0.25
620,20,C Bisson (JER),2019-2019,14,14,3,3,0,0,3,1 (1ct 0st),0.214
621,21,A Bohara (NEPAL),2019-2019,17,17,3,3,0,0,3,1 (1ct 0st),0.17600000000000002
622,22,DG Brownlie (NZ),2010-2014,5,5,3,3,0,0,3,1 (1ct 0st),0.6
623,23,IG Butler (NZ),2009-2013,19,19,3,3,0,0,3,1 (1ct 0st),0.157
624,24,J Butler (GUE),2019-2019,9,9,3,3,0,0,3,1 (1ct 0st),0.33299999999999996
625,25,C Carter (HKG),2015-2017,10,10,3,2,1,2,0,1 (1ct 0st),0.3
626,26,C Chete (MWI),2019-2019,2,2,3,3,0,3,0,2 (2ct 0st),1.5
627,27,LA Collado (GIBR),2019-2019,4,4,3,2,1,2,0,1 (1ct 0st),0.75
628,28,PC Connell (IRE),2008-2010,9,8,3,3,0,0,3,1 (1ct 0st),0.375
629,29,TK Curran (ENG),2017-2019,15,15,3,3,0,0,3,1 (1ct 0st),0.2
630,30,CJ Dala (SA),2018-2019,9,9,3,3,0,0,3,1 (1ct 0st),0.33299999999999996
631,31,SM Davies (ENG),2009-2011,5,5,3,2,1,2,0,2 (2ct 0st),0.6
632,32,CD de Lange (SCOT),2015-2017,8,7,3,3,0,0,3,1 (1ct 0st),0.428
633,33,Delawar Khan (DEN),2019-2019,9,7,3,3,0,0,3,2 (2ct 0st),0.428
634,34,BFW de Leede (NL),2018-2019,8,8,3,3,0,0,3,1 (1ct 0st),0.375
635,35,JL Denly (ENG),2009-2019,10,10,3,3,0,0,3,1 (1ct 0st),0.3
636,36,N Dutta (CAN),2019-2019,11,11,3,3,0,0,3,2 (2ct 0st),0.272
637,37,LH Ferguson (NZ),2017-2019,8,8,3,3,0,0,3,2 (2ct 0st),0.375
638,38,CRD Fernando (SL),2006-2016,18,18,3,3,0,0,3,1 (1ct 0st),0.166
639,39,Fiaz Ahmed (BAH),2019-2019,4,4,3,3,0,0,3,2 (2ct 0st),0.75
640,40,Fitri Sham (MAL),2019-2019,15,14,3,3,0,0,3,1 (1ct 0st),0.214
641,41,SC Getkate (IRE),2019-2019,14,14,3,3,0,0,3,2 (2ct 0st),0.214
642,42,D Gim (NGA),2019-2019,6,6,3,3,0,0,3,2 (2ct 0st),0.5
643,43,BD Glover (NL),2019-2019,19,19,3,3,0,0,3,1 (1ct 0st),0.157
644,44,LF Goncalves (),2019-2019,3,3,3,1,2,1,0,2 (1ct 1st),1.0
645,45,Z Groenewald (NAM),2019-2019,10,10,3,3,0,0,3,1 (1ct 0st),0.3
646,46,GM Hamilton (SCOT),2007-2010,12,11,3,3,0,0,3,2 (2ct 0st),0.272
647,47,Haris Sohail (PAK),2013-2019,14,14,3,3,0,0,3,2 (2ct 0st),0.214
648,48,BE Hendricks (SA),2014-2019,11,11,3,3,0,0,3,2 (2ct 0st),0.272
649,49,MC Henriques (AUS),2009-2017,11,11,3,3,0,0,3,1 (1ct 0st),0.272
650,0,JR Hopes (AUS),2005-2010,12,12,3,3,0,0,3,1 (1ct 0st),0.25
651,1,Ibrarul Haq (Saudi),2019-2019,5,5,3,3,0,0,3,3 (3ct 0st),0.6
652,2,Imran Farhat (PAK),2010-2011,7,7,3,3,0,0,3,1 (1ct 0st),0.428
653,3,Imran Khan (1) (PAK),2015-2015,3,3,3,3,0,0,3,2 (2ct 0st),1.0
654,4,Inam-ul-Haq (QAT),2019-2019,11,11,3,3,0,0,3,1 (1ct 0st),0.272
655,5,MM Iqbal (SCOT),2012-2013,6,6,3,3,0,0,3,1 (1ct 0st),0.5
656,6,Izatullah Dawlatzai (AFG/GER),2012-2019,14,14,3,3,0,0,3,2 (2ct 0st),0.214
657,7,Jahurul Islam (BDESH),2010-2013,3,3,3,3,0,0,3,1 (1ct 0st),1.0
658,8,GSNFG Jayasuriya (SL),2015-2019,16,16,3,3,0,0,3,1 (1ct 0st),0.187
659,9,S Jora (NEPAL),2019-2019,6,6,3,3,0,0,3,1 (1ct 0st),0.5
660,10,I Katzarski (),2019-2019,3,3,3,3,0,0,3,2 (2ct 0st),1.0
661,11,S Kaveri (Mex),2019-2019,7,7,3,3,0,0,3,2 (2ct 0st),0.428
662,12,JM Kemp (SA),2005-2007,8,8,3,3,0,0,3,1 (1ct 0st),0.375
663,13,Khurram Nawaz (OMAN),2017-2019,18,18,3,3,0,0,3,1 (1ct 0st),0.166
664,14,J Kila (PNG),2019-2019,12,12,3,3,0,0,3,2 (2ct 0st),0.25
665,15,AK Kitchen (NZ),2017-2018,5,4,3,3,0,0,3,2 (2ct 0st),0.75
666,16,RAS Lakmal (SL),2011-2019,11,11,3,3,0,0,3,1 (1ct 0st),0.272
667,17,S Lamichhane (ICC/NEPAL),2018-2019,18,18,3,3,0,0,3,1 (1ct 0st),0.166
668,18,KS Leverock (BMUDA),2019-2019,12,12,3,3,0,0,3,1 (1ct 0st),0.25
669,19,CA Lynn (AUS),2014-2018,18,17,3,3,0,0,3,1 (1ct 0st),0.17600000000000002
670,20,WK McCallan (IRE),2008-2009,9,8,3,3,0,0,3,1 (1ct 0st),0.375
671,21,R McLaren (SA),2009-2014,12,12,3,3,0,0,3,1 (1ct 0st),0.25
672,22,CD McMillan (NZ),2005-2007,8,8,3,3,0,0,3,2 (2ct 0st),0.375
673,23,WJ Malinda (Mald),2019-2019,3,3,3,3,0,0,3,2 (2ct 0st),1.0
674,24,SE Marsh (AUS),2008-2016,15,15,3,3,0,0,3,2 (2ct 0st),0.2
675,25,RD McCann (IRE),2012-2012,3,3,3,1,2,1,0,2 (0ct 2st),1.0
676,26,Md Shafiqul Haque (THAI),2019-2019,4,4,3,1,2,1,0,1 (1ct 0st),0.75
677,27,GP Meade (ITA),2019-2019,8,7,3,3,0,0,3,1 (1ct 0st),0.428
678,28,Mehran Khan (OMAN),2015-2019,19,18,3,3,0,0,3,1 (1ct 0st),0.166
679,29,T Mishra (KENYA),2007-2013,15,15,3,3,0,0,3,1 (1ct 0st),0.2
680,30,Mohamed Rishwan (Mald),2019-2019,11,11,3,3,0,0,3,1 (1ct 0st),0.272
681,31,Mohammad Asif (PAK),2006-2010,11,11,3,3,0,0,3,1 (1ct 0st),0.272
682,32,Mohammad Mithun (BDESH),2014-2019,14,12,3,3,0,0,3,2 (2ct 0st),0.25
683,33,Mohammad Saifuddin (BDESH),2017-2019,13,13,3,3,0,0,3,1 (1ct 0st),0.23
684,34,Mohammad Sami (PAK),2010-2016,13,13,3,3,0,0,3,1 (1ct 0st),0.23
685,35,JM Muirhead (AUS),2014-2014,5,5,3,3,0,0,3,1 (1ct 0st),0.6
686,36,Mujeeb Ur Rahman (AFG),2018-2019,16,16,3,3,0,0,3,1 (1ct 0st),0.187
687,37,AA Mulla (CAN),2008-2008,4,4,3,1,2,1,0,1 (1ct 0st),0.75
688,38,T Munyonga (ZIM),2019-2019,5,5,3,3,0,0,3,2 (2ct 0st),0.6
689,39,TJ Murtagh (IRE),2012-2016,14,14,3,3,0,0,3,1 (1ct 0st),0.214
690,40,Najeeb Tarakai (AFG),2014-2019,12,12,3,3,0,0,3,2 (2ct 0st),0.25
691,41,M Nasim Baras (AFG),2015-2015,3,3,3,3,0,0,3,2 (2ct 0st),1.0
692,42,A Ndlovu (ZIM),2019-2019,3,3,3,3,0,0,3,2 (2ct 0st),1.0
693,43,PM Nevill (AUS),2016-2016,9,9,3,2,1,2,0,1 (1ct 0st),0.33299999999999996
694,44,DO Obuya (KENYA),2007-2012,10,10,3,2,1,1,1,1 (1ct 0st),0.3
695,45,H Patel (CAN),2010-2013,11,11,3,3,0,0,3,1 (1ct 0st),0.272
696,46,SR Patel (ENG),2011-2013,18,18,3,3,0,0,3,1 (1ct 0st),0.166
697,47,JL Pattinson (AUS),2011-2012,4,4,3,3,0,0,3,2 (2ct 0st),0.75
698,48,Pavandeep Singh (MAL),2019-2019,10,10,3,3,0,0,3,2 (2ct 0st),0.3
699,49,RW Price (ZIM),2008-2012,16,16,3,3,0,0,3,1 (1ct 0st),0.187
700,0,S Qeshile (SA),2019-2019,2,2,3,3,0,3,0,2 (2ct 0st),1.5
701,1,K Rabada (SA),2014-2019,21,21,3,3,0,0,3,1 (1ct 0st),0.142
702,2,LN Rajbanshi (NEPAL),2018-2019,12,12,3,3,0,0,3,1 (1ct 0st),0.25
703,3,Aminuddin Ramly (MAL),2019-2019,10,9,3,3,0,0,3,2 (2ct 0st),0.33299999999999996
704,4,S Ravikumar (CRC),2019-2019,3,3,3,3,0,0,3,2 (2ct 0st),1.0
705,5,AJ Redmond (NZ),2009-2010,7,7,3,3,0,0,3,2 (2ct 0st),0.428
706,6,KA Reynolds (Blz),2019-2019,3,3,3,3,0,0,3,2 (2ct 0st),1.0
707,7,MJ Ross (ITA),2019-2019,8,7,3,3,0,0,3,2 (2ct 0st),0.428
708,8,Saad Bin Zafar (CAN),2019-2019,11,11,3,3,0,0,3,1 (1ct 0st),0.272
709,9,Sajid Cheema (Saudi),2019-2019,5,5,3,3,0,0,3,1 (1ct 0st),0.6
710,10,Salman Butt (PAK),2007-2010,24,24,3,3,0,0,3,1 (1ct 0st),0.125
711,11,P Sarraf (NEPAL),2019-2019,9,9,3,3,0,0,3,1 (1ct 0st),0.33299999999999996
712,12,BM Scholtz (NAM),2019-2019,14,14,3,3,0,0,3,1 (1ct 0st),0.214
713,13,SMSM Senanayake (SL),2012-2016,24,24,3,3,0,0,3,1 (1ct 0st),0.125
714,14,Shahzaib Hasan (PAK),2009-2010,10,10,3,3,0,0,3,2 (2ct 0st),0.3
715,15,D Sheeli (KUW),2019-2019,3,3,3,3,0,0,3,3 (3ct 0st),1.0
716,16,NK Shetty (Mex),2019-2019,2,2,3,3,0,0,3,2 (2ct 0st),1.5
717,17,Shiraz Khan (KUW),2019-2019,6,6,3,3,0,0,3,1 (1ct 0st),0.5
718,18,P Silas (Botsw),2019-2019,4,4,3,3,0,0,3,1 (1ct 0st),0.75
719,19,VS Solanki (ENG),2005-2007,3,3,3,3,0,2,1,2 (2ct 0st),1.0
720,20,MWR Stokes (GUE),2019-2019,9,9,3,3,0,0,3,1 (1ct 0st),0.33299999999999996
721,21,AO Suji (KENYA),2007-2010,8,8,3,3,0,0,3,1 (1ct 0st),0.375
722,22,CR Suryawanshi (SGP),2019-2019,3,3,3,3,0,0,3,1 (1ct 0st),1.0
723,23,A Symonds (AUS),2005-2009,14,14,3,3,0,0,3,1 (1ct 0st),0.214
724,24,SW Tait (AUS),2007-2016,21,21,3,3,0,0,3,1 (1ct 0st),0.142
725,25,SN Thakur (INDIA),2018-2018,7,7,3,3,0,0,3,1 (1ct 0st),0.428
726,26,OFJ Tonuu (Samoa),2019-2019,4,4,3,3,0,3,0,1 (1ct 0st),0.75
727,27,JD Unadkat (INDIA),2016-2018,10,10,3,3,0,0,3,1 (1ct 0st),0.3
728,28,LV van Beek (NL),2014-2016,8,8,3,3,0,0,3,1 (1ct 0st),0.375
729,29,HE van der Dussen (SA),2018-2019,9,9,3,3,0,0,3,2 (2ct 0st),0.33299999999999996
730,30,M Vijay (INDIA),2010-2015,9,9,3,3,0,0,3,1 (1ct 0st),0.33299999999999996
731,31,TP Visee (NL),2015-2019,27,26,3,3,0,0,3,1 (1ct 0st),0.115
732,32,AC Voges (AUS),2007-2013,7,7,3,3,0,0,3,1 (1ct 0st),0.428
733,33,C Waiswa (UGA),2019-2019,4,4,3,3,0,0,3,1 (1ct 0st),0.75
734,34,HR Walsh (USA/WI),2019-2019,13,13,3,3,0,0,3,1 (1ct 0st),0.23
735,35,BJ Watling (NZ),2009-2014,5,5,3,3,0,2,1,1 (1ct 0st),0.6
736,36,UT Yadav (INDIA),2012-2019,7,7,3,3,0,0,3,1 (1ct 0st),0.428
737,37,KJ Young (Blz),2019-2019,3,3,3,3,0,3,0,1 (1ct 0st),1.0
738,38,SA Abbott (AUS),2014-2019,4,4,2,2,0,0,2,2 (2ct 0st),0.5
739,39,Abdullah Akbarjan (Aut),2019-2019,5,5,2,2,0,0,2,1 (1ct 0st),0.4
740,40,Abdul Razzaq (PAK),2006-2013,32,32,2,2,0,0,2,1 (1ct 0st),0.062
741,41,Abdul Shakoor (ROM),2019-2019,2,2,2,1,1,1,0,2 (1ct 1st),1.0
742,42,AS Abioye (NGA),2019-2019,5,5,2,2,0,0,2,1 (1ct 0st),0.4
743,43,IKO Aboagye (Ghana),2019-2019,4,4,2,2,0,0,2,1 (1ct 0st),0.5
744,44,Abu Hider (BDESH),2016-2018,13,12,2,2,0,0,2,1 (1ct 0st),0.166
745,45,Abdul Hashmi (DEN),2019-2019,8,6,2,1,1,1,0,1 (1ct 0st),0.33299999999999996
746,46,Ahmed Faiz (MAL),2019-2019,10,9,2,2,0,0,2,1 (1ct 0st),0.222
747,47,CM Akachukwu (NGA),2019-2019,8,8,2,2,0,0,2,2 (2ct 0st),0.25
748,48,DI Allan (KENYA),2012-2013,10,10,2,2,0,0,2,1 (1ct 0st),0.2
749,49,Alok Kapali (BDESH),2007-2011,7,7,2,2,0,0,2,1 (1ct 0st),0.285
750,0,TR Ambrose (ENG),2008-2008,1,1,2,1,1,1,0,2 (1ct 1st),2.0
751,1,Amjad Khan (UAE),2015-2016,4,4,2,2,0,0,2,1 (1ct 0st),0.5
752,2,Amjad Mahboob (SGP),2019-2019,11,11,2,2,0,0,2,1 (1ct 0st),0.18100000000000002
753,3,Amjad Sher (Fin),2019-2019,5,5,2,2,0,0,2,1 (1ct 0st),0.4
754,4,Anamul Haque (BDESH),2012-2015,13,12,2,2,0,1,1,1 (1ct 0st),0.166
755,5,Anique Uddin (DEN),2019-2019,6,5,2,2,0,0,2,1 (1ct 0st),0.4
756,6,R Ankad (Mex),2019-2019,8,8,2,2,0,0,2,1 (1ct 0st),0.25
757,7,Anwar Arudin (MAL),2019-2019,12,11,2,2,0,0,2,1 (1ct 0st),0.18100000000000002
758,8,Anwar Rahman (MAL),2019-2019,9,8,2,2,0,0,2,1 (1ct 0st),0.25
759,9,Areeb Quadir (Fin),2019-2019,2,2,2,2,0,0,2,2 (2ct 0st),1.0
760,10,Ashfaq Ahmed (UAE),2018-2019,12,12,2,2,0,0,2,1 (1ct 0st),0.166
761,11,MNM Aslam (KUW),2019-2019,6,6,2,2,0,0,2,1 (1ct 0st),0.33299999999999996
762,12,Asrar Ahmed (),2019-2019,3,3,2,2,0,0,2,1 (1ct 0st),0.6659999999999999
763,13,AA Banner (Blz),2019-2019,3,3,2,2,0,0,2,2 (2ct 0st),0.6659999999999999
764,14,GG Banner (Blz),2019-2019,3,3,2,2,0,0,2,2 (2ct 0st),0.6659999999999999
765,15,LJ Barker (GUE),2019-2019,9,9,2,2,0,0,2,1 (1ct 0st),0.222
766,16,GEF Barnett (CAN),2008-2010,5,5,2,2,0,0,2,1 (1ct 0st),0.4
767,17,CD Barnwell (WI),2011-2013,6,6,2,2,0,0,2,1 (1ct 0st),0.33299999999999996
768,18,A Bhagwat (HKG),2019-2019,4,4,2,2,0,2,0,2 (2ct 0st),0.5
769,19,M Bhanuka (SL),2019-2019,2,2,2,2,0,2,0,1 (1ct 0st),1.0
770,20,RA Bhatti (CAN),2012-2012,4,4,2,1,1,1,0,1 (1ct 0st),0.5
771,21,DE Bollinger (AUS),2011-2014,9,9,2,2,0,0,2,1 (1ct 0st),0.222
772,22,JP Bray (IRE),2009-2009,2,2,2,2,0,0,2,1 (1ct 0st),1.0
773,23,GB Brent (ZIM),2006-2007,3,3,2,2,0,0,2,2 (2ct 0st),0.6659999999999999
774,24,PR Brown (ENG),2019-2019,4,4,2,2,0,0,2,1 (1ct 0st),0.5
775,25,AF Buurman (NL),2010-2010,4,4,2,1,1,1,0,2 (1ct 1st),0.5
776,26,VD Chandra (PNM),2019-2019,3,3,2,2,0,2,0,1 (1ct 0st),0.6659999999999999
777,27,BB Chari (ZIM),2019-2019,3,3,2,2,0,0,2,1 (1ct 0st),0.6659999999999999
778,28,PP Chawla (INDIA),2010-2012,7,7,2,2,0,0,2,2 (2ct 0st),0.285
779,29,CK Coventry (ZIM),2010-2015,13,13,2,2,0,1,1,1 (1ct 0st),0.153
780,30,KM Dabengwa (ZIM),2006-2010,8,8,2,2,0,0,2,1 (1ct 0st),0.25
781,31,F Damiao Couana (Moz),2019-2019,7,6,2,2,0,0,2,1 (1ct 0st),0.33299999999999996
782,32,P Danci (ROM),2019-2019,2,2,2,2,0,0,2,2 (2ct 0st),1.0
783,33,RR David (CAN),2008-2008,4,4,2,2,0,0,2,1 (1ct 0st),0.5
784,34,JM Davison (CAN),2008-2010,5,5,2,2,0,0,2,1 (1ct 0st),0.4
785,35,LA Dawson (ENG),2016-2018,6,6,2,2,0,0,2,1 (1ct 0st),0.33299999999999996
786,36,TB de Bruyn (SA),2017-2017,2,2,2,2,0,0,2,2 (2ct 0st),1.0
787,37,N Deonarine (WI),2010-2013,8,8,2,2,0,0,2,2 (2ct 0st),0.25
788,38,AP Devcich (NZ),2013-2014,4,4,2,2,0,0,2,2 (2ct 0st),0.5
789,39,R Dhawan (INDIA),2016-2016,1,1,2,2,0,0,2,2 (2ct 0st),2.0
790,40,GD Drummond (SCOT),2008-2013,17,17,2,2,0,0,2,1 (1ct 0st),0.11699999999999999
791,41,L Emilio (Moz),2019-2019,5,4,2,2,0,0,2,1 (1ct 0st),0.5
792,42,GDR Eranga (CAN),2019-2019,9,9,2,2,0,0,2,1 (1ct 0st),0.222
793,43,Faran Afzal (ESP),2019-2019,9,9,2,2,0,0,2,1 (1ct 0st),0.222
794,44,Fayyaz Butt (OMAN),2019-2019,14,14,2,2,0,0,2,1 (1ct 0st),0.142
795,45,A Ferguson (Arg),2019-2019,5,5,2,2,0,0,2,1 (1ct 0st),0.4
796,46,N Pradeep (SL),2016-2019,14,14,2,2,0,0,2,1 (1ct 0st),0.142
797,47,WIA Fernando (SL),2019-2019,10,10,2,2,0,0,2,1 (1ct 0st),0.2
798,48,NJ Ferraby (JER),2019-2019,14,14,2,2,0,0,2,1 (1ct 0st),0.142
799,49,SP Fleming (NZ),2005-2006,5,5,2,2,0,0,2,1 (1ct 0st),0.4
800,0,DR Flynn (NZ),2008-2012,5,5,2,2,0,0,2,1 (1ct 0st),0.4
801,1,JD Freyone (GIBR),2019-2019,4,4,2,2,0,0,2,2 (2ct 0st),0.5
802,2,GC Galanis (),2019-2019,2,2,2,2,0,0,2,1 (1ct 0st),1.0
803,3,V Ganesan (GER),2019-2019,4,4,2,2,0,0,2,1 (1ct 0st),0.5
804,4,CJ Gannon (USA),2019-2019,4,4,2,2,0,0,2,2 (2ct 0st),0.5
805,5,Habib Ahmadzai (Aut),2019-2019,5,5,2,2,0,0,2,1 (1ct 0st),0.4
806,6,Hamid Hassan (AFG),2010-2016,22,22,2,2,0,0,2,1 (1ct 0st),0.09
807,7,Hammad Azam (PAK),2012-2013,5,5,2,2,0,0,2,1 (1ct 0st),0.4
808,8,Jandu Hamoud (KUW),2019-2019,6,6,2,2,0,0,2,1 (1ct 0st),0.33299999999999996
809,9,AS Hansra (CAN),2012-2013,8,8,2,2,0,0,2,1 (1ct 0st),0.25
810,10,Haseeb Amjad (HKG),2014-2016,18,18,2,2,0,0,2,1 (1ct 0st),0.111
811,11,JW Hastings (AUS),2010-2016,9,9,2,2,0,0,2,1 (1ct 0st),0.222
812,12,C Hauptfleisch (Caym),2019-2019,5,5,2,1,1,1,0,1 (1ct 0st),0.4
813,13,Hazratullah Zazai (AFG),2016-2019,13,13,2,2,0,0,2,1 (1ct 0st),0.153
814,14,L Hermida (Mex),2019-2019,5,5,2,2,0,0,2,1 (1ct 0st),0.4
815,15,D Heyliger (CAN),2019-2019,11,11,2,2,0,0,2,1 (1ct 0st),0.18100000000000002
816,16,RM Hira (NZ),2012-2013,15,15,2,2,0,0,2,1 (1ct 0st),0.133
817,17,Hirenkumar Patel (Chile),2019-2019,4,4,2,2,0,0,2,1 (1ct 0st),0.5
818,18,S Hirugade (Mex),2019-2019,6,6,2,2,0,0,2,1 (1ct 0st),0.33299999999999996
819,19,Imran Anwar (BAH),2019-2019,4,4,2,2,0,0,2,1 (1ct 0st),0.5
820,20,Imran Ali (KUW),2019-2019,4,4,2,2,0,0,2,2 (2ct 0st),0.5
821,21,CA Ingram (SA),2010-2012,9,9,2,2,0,0,2,1 (1ct 0st),0.222
822,22,Irfan Ahmed (HKG),2014-2015,8,8,2,2,0,0,2,1 (1ct 0st),0.25
823,23,Ismat Ullah (),2019-2019,4,4,2,2,0,0,2,1 (1ct 0st),0.5
824,24,H Ivanov (),2019-2019,3,3,2,2,0,2,0,1 (1ct 0st),0.6659999999999999
825,25,Joginder Sharma (INDIA),2007-2007,4,4,2,2,0,0,2,1 (1ct 0st),0.5
826,26,GO Jones (ENG),2005-2006,2,2,2,2,0,2,0,1 (1ct 0st),1.0
827,27,MBS Jonkman (NL),2010-2010,3,3,2,2,0,0,2,2 (2ct 0st),0.6659999999999999
828,28,Junaid Siddiqui (CAN),2012-2019,13,13,2,2,0,0,2,1 (1ct 0st),0.153
829,29,Junaid Siddique (UAE),2019-2019,8,8,2,2,0,0,2,1 (1ct 0st),0.25
830,30,Karweng NG (PHI),2019-2019,4,4,2,2,0,0,2,2 (2ct 0st),0.5
831,31,MS Kasprowicz (AUS),2005-2005,2,2,2,2,0,0,2,1 (1ct 0st),1.0
832,32,SM Katich (AUS),2005-2006,3,3,2,2,0,0,2,1 (1ct 0st),0.6659999999999999
833,33,Z Khan (INDIA),2006-2012,17,17,2,2,0,0,2,1 (1ct 0st),0.11699999999999999
834,34,Khurram Khan (UAE),2014-2014,3,3,2,2,0,0,2,1 (1ct 0st),0.6659999999999999
835,35,M Klinger (AUS),2017-2017,3,3,2,2,0,0,2,1 (1ct 0st),0.6659999999999999
836,36,HGJM Kulatunga (SL),2008-2008,2,2,2,2,0,0,2,2 (2ct 0st),1.0
837,37,JS Kundi (KENYA),2019-2019,6,6,2,2,0,0,2,1 (1ct 0st),0.33299999999999996
838,38,A Lark (Aut),2019-2019,5,5,2,2,0,0,2,1 (1ct 0st),0.4
839,39,LC Le Tissier (GUE),2019-2019,9,9,2,2,0,0,2,2 (2ct 0st),0.222
840,40,JB Little (IRE),2016-2019,11,11,2,2,0,0,2,1 (1ct 0st),0.18100000000000002
841,41,MF Maharoof (SL),2006-2016,8,8,2,2,0,0,2,1 (1ct 0st),0.25
842,42,NA Maiolo (ITA),2019-2019,8,7,2,2,0,0,2,1 (1ct 0st),0.285
843,43,DJ Malan (ENG),2017-2019,9,9,2,2,0,0,2,1 (1ct 0st),0.222
844,44,JN Malan (SA),2019-2019,2,2,2,2,0,0,2,1 (1ct 0st),1.0
845,45,A Manousis (),2019-2019,3,3,2,2,0,0,2,1 (1ct 0st),0.6659999999999999
846,46,Mansoor Amjad (PAK),2008-2008,1,1,2,2,0,0,2,2 (2ct 0st),2.0
847,47,A Martin (WI),2011-2011,1,1,2,2,0,0,2,2 (2ct 0st),2.0
848,48,SW Masakadza (ZIM),2010-2013,7,7,2,2,0,0,2,1 (1ct 0st),0.285
849,49,WT Mashinge (ZIM),2019-2019,2,2,2,2,0,0,2,2 (2ct 0st),1.0
850,0,NO Miller (WI),2009-2014,9,9,2,2,0,0,2,1 (1ct 0st),0.222
851,1,SF Mire (ZIM),2018-2019,9,9,2,2,0,0,2,1 (1ct 0st),0.222
852,2,Mohammad Ghazanfar (HKG),2019-2019,5,5,2,2,0,0,2,1 (1ct 0st),0.4
853,3,Mohammad Naim (BDESH),2019-2019,3,3,2,2,0,0,2,2 (2ct 0st),0.6659999999999999
854,4,Mohammad Salman (PAK),2011-2011,1,1,2,1,1,1,0,2 (1ct 1st),2.0
855,5,Mohammed Asghar (KUW),2019-2019,4,4,2,2,0,0,2,1 (1ct 0st),0.5
856,6,Mohammed Nurji (MWI),2019-2019,6,6,2,2,0,0,2,1 (1ct 0st),0.33299999999999996
857,7,RS Morton (WI),2006-2010,7,7,2,2,0,0,2,1 (1ct 0st),0.285
858,8,Muhammad Kashif (KUW),2019-2019,10,10,2,2,0,0,2,1 (1ct 0st),0.2
859,9,Muhammad Nadeem (Saudi),2019-2019,5,5,2,2,0,0,2,2 (2ct 0st),0.4
860,10,RG Mukasa (UGA),2019-2019,4,4,2,2,0,0,2,1 (1ct 0st),0.5
861,11,Mukhtar Ahmed (PAK),2015-2015,6,6,2,2,0,0,2,1 (1ct 0st),0.33299999999999996
862,12,J Mulder (IRE),2016-2017,8,8,2,2,0,0,2,1 (1ct 0st),0.25
863,13,G Murali (CRC),2019-2019,3,3,2,2,0,2,0,1 (1ct 0st),0.6659999999999999
864,14,Murid Ekrami (Belg),2019-2019,3,3,2,2,0,0,2,2 (2ct 0st),0.6659999999999999
865,15,TK Musakanda (ZIM),2018-2018,6,6,2,2,0,0,2,1 (1ct 0st),0.33299999999999996
866,16,LA Musiani (Arg),2019-2019,5,5,2,2,0,0,2,1 (1ct 0st),0.4
867,17,CT Mutombodzi (ZIM),2013-2019,13,13,2,2,0,0,2,1 (1ct 0st),0.153
868,18,B Muzarabani (ZIM),2018-2018,6,6,2,2,0,0,2,1 (1ct 0st),0.33299999999999996
869,19,Naeem Islam (BDESH),2008-2013,10,10,2,2,0,0,2,1 (1ct 0st),0.2
870,20,Nanda Kumar (CRC),2019-2019,3,3,2,2,0,0,2,2 (2ct 0st),0.6659999999999999
871,21,N Nankov (),2019-2019,3,3,2,2,0,0,2,1 (1ct 0st),0.6659999999999999
872,22,Naved-ul-Hasan (PAK),2006-2010,4,4,2,2,0,0,2,1 (1ct 0st),0.5
873,23,Nawazish Jezuli (Saudi),2019-2019,1,1,2,2,0,2,0,2 (2ct 0st),2.0
874,24,Najmul Hossain Shanto (BDESH),2019-2019,2,2,2,2,0,0,2,1 (1ct 0st),1.0
875,25,Nazmul Islam (BDESH),2018-2018,13,13,2,2,0,0,2,1 (1ct 0st),0.153
876,26,Nazwan Ismail (Mald),2019-2019,3,3,2,2,0,0,2,1 (1ct 0st),0.6659999999999999
877,27,P Negi (INDIA),2016-2016,1,1,2,2,0,0,2,2 (2ct 0st),2.0
878,28,K Nestor (GIBR),2019-2019,4,4,2,2,0,0,2,1 (1ct 0st),0.5
879,29,G Nikitas (),2019-2019,2,2,2,0,2,0,0,2 (0ct 2st),1.0
880,30,Noor Momand (Belg),2019-2019,2,2,2,2,0,2,0,1 (1ct 0st),1.0
881,31,F Nsubuga (UGA),2019-2019,3,3,2,2,0,0,2,1 (1ct 0st),0.6659999999999999
882,32,M Ntini (SA),2005-2011,10,10,2,2,0,0,2,1 (1ct 0st),0.2
883,33,GH O'Brien (BMUDA),2008-2019,11,11,2,2,0,0,2,1 (1ct 0st),0.18100000000000002
884,34,SA Okpe (NGA),2019-2019,8,8,2,2,0,0,2,1 (1ct 0st),0.25
885,35,LN Oluoch (KENYA),2013-2019,10,10,2,2,0,0,2,1 (1ct 0st),0.2
886,36,AA Onikoyi (NGA),2019-2019,9,9,2,2,0,2,0,1 (1ct 0st),0.222
887,37,E Otieno (KENYA),2012-2019,18,18,2,2,0,0,2,1 (1ct 0st),0.111
888,38,KO Otieno (KENYA),2008-2008,4,4,2,2,0,0,2,1 (1ct 0st),0.5
889,39,HC Overdijk (NL),2018-2019,4,3,2,2,0,0,2,2 (2ct 0st),0.6659999999999999
890,40,AM Oyede (NGA),2019-2019,8,8,2,2,0,0,2,2 (2ct 0st),0.25
891,41,T Panyangara (ZIM),2013-2016,14,14,2,2,0,0,2,1 (1ct 0st),0.142
892,42,AE Paraam (SGP),2019-2019,3,3,2,2,0,0,2,1 (1ct 0st),0.6659999999999999
893,43,SD Parry (ENG),2014-2015,5,5,2,2,0,0,2,2 (2ct 0st),0.4
894,44,IK Pathan (INDIA),2006-2012,24,23,2,2,0,0,2,1 (1ct 0st),0.086
895,45,KMA Paul (WI),2018-2019,18,18,2,2,0,0,2,1 (1ct 0st),0.111
896,46,T Perera (Botsw),2019-2019,6,6,2,2,0,0,2,1 (1ct 0st),0.33299999999999996
897,47,JE Pitcher (BMUDA),2019-2019,3,3,2,2,0,0,2,2 (2ct 0st),0.6659999999999999
898,48,OL Pitcher (BMUDA),2008-2008,3,3,2,2,0,0,2,2 (2ct 0st),0.6659999999999999
899,49,SM Pollock (SA),2005-2008,12,12,2,2,0,0,2,1 (1ct 0st),0.166
900,0,NS Poonia (SCOT),2007-2010,8,7,2,2,0,0,2,1 (1ct 0st),0.285
901,1,A Poulose (OMAN),2017-2017,3,3,2,2,0,0,2,1 (1ct 0st),0.6659999999999999
902,2,DBL Powell (WI),2007-2007,5,5,2,2,0,0,2,1 (1ct 0st),0.4
903,3,AD Poynter (IRE),2012-2016,19,17,2,2,0,0,2,1 (1ct 0st),0.11699999999999999
904,4,A Pusthay (Fin),2019-2019,5,5,2,2,0,0,2,1 (1ct 0st),0.4
905,5,Qadeer Ahmed (UAE),2015-2019,10,10,2,2,0,0,2,1 (1ct 0st),0.2
906,6,Raees Ahmadzai (AFG),2010-2010,8,8,2,2,0,0,2,1 (1ct 0st),0.25
907,7,Raag Kapur (HKG),2019-2019,4,4,2,2,0,0,2,1 (1ct 0st),0.5
908,8,S Rakshit (CZK-R),2019-2019,7,7,2,2,0,0,2,1 (1ct 0st),0.285
909,9,R Rampaul (WI),2007-2015,23,23,2,2,0,0,2,1 (1ct 0st),0.086
910,10,Raza-ur-Rehman (CAN),2012-2013,5,5,2,2,0,0,2,1 (1ct 0st),0.4
911,11,Raza Hasan (PAK),2012-2014,10,10,2,2,0,0,2,1 (1ct 0st),0.2
912,12,DJ Reekers (NL),2008-2009,6,5,2,2,0,0,2,1 (1ct 0st),0.4
913,13,GA Reynold (Blz),2019-2019,3,3,2,2,0,0,2,2 (2ct 0st),0.6659999999999999
914,14,LH Rodrigues (),2019-2019,4,4,2,2,0,0,2,1 (1ct 0st),0.5
915,15,R Rohan (SGP),2019-2019,10,10,2,2,0,0,2,1 (1ct 0st),0.2
916,16,S Rossi (Arg),2019-2019,5,5,2,2,0,0,2,1 (1ct 0st),0.4
917,17,Saber Zakhil (Belg),2019-2019,3,3,2,2,0,0,2,1 (1ct 0st),0.6659999999999999
918,18,S Saeed (Mald),2019-2019,5,5,2,2,0,0,2,2 (2ct 0st),0.4
919,19,Sagar Pun (NEPAL),2014-2015,9,9,2,2,0,0,2,1 (1ct 0st),0.222
920,20,Sahibzada Farhan (PAK),2018-2018,3,3,2,2,0,0,2,2 (2ct 0st),0.6659999999999999
921,21,J Salazar (Peru),2019-2019,2,2,2,2,0,0,2,1 (1ct 0st),1.0
922,22,Saqib Zulfiqar (NL),2018-2019,6,6,2,2,0,0,2,2 (2ct 0st),0.33299999999999996
923,23,A Sathya (Mex),2019-2019,3,3,2,2,0,0,2,1 (1ct 0st),0.6659999999999999
924,24,V Sehwag (INDIA),2006-2012,19,18,2,2,0,0,2,1 (1ct 0st),0.111
925,25,Shaikh Ashraf (Peru),2019-2019,4,4,2,2,0,0,2,2 (2ct 0st),0.5
926,26,Shakeel Ansar (PAK),2012-2012,2,2,2,1,1,1,0,2 (1ct 1st),1.0
927,27,PH Shamdasani (Peru),2019-2019,4,4,2,2,0,0,2,1 (1ct 0st),0.5
928,28,Shamsur Rahman (BDESH),2013-2014,9,8,2,2,0,0,2,1 (1ct 0st),0.25
929,29,V Shankar (INDIA),2018-2019,9,9,2,2,0,0,2,1 (1ct 0st),0.222
930,30,Shoaib Akhtar (PAK),2006-2010,15,15,2,2,0,0,2,1 (1ct 0st),0.133
931,31,Shoaib Ali (Saudi),2019-2019,5,5,2,2,0,0,2,2 (2ct 0st),0.4
932,32,Shoaib Qureshi (Fin),2019-2019,5,5,2,2,0,0,2,1 (1ct 0st),0.4
933,33,Sidhant Singh (SGP),2019-2019,8,8,2,2,0,0,2,1 (1ct 0st),0.25
934,34,RP Singh (INDIA),2007-2009,10,9,2,2,0,0,2,1 (1ct 0st),0.222
935,35,L Sipamla (SA),2019-2019,5,5,2,2,0,0,2,1 (1ct 0st),0.4
936,36,S Smith (BMUDA),2019-2019,5,5,2,2,0,2,0,1 (1ct 0st),0.4
937,37,S Snater (NL),2018-2019,13,12,2,2,0,0,2,1 (1ct 0st),0.166
938,38,Sohag Gazi (BDESH),2012-2015,10,10,2,2,0,0,2,1 (1ct 0st),0.2
939,39,CA Soper (PNG),2015-2019,13,13,2,2,0,0,2,1 (1ct 0st),0.153
940,40,S Sreesanth (INDIA),2006-2008,10,9,2,2,0,0,2,2 (2ct 0st),0.222
941,41,H Srinivasan (GER),2019-2019,1,1,2,1,1,1,0,2 (1ct 1st),2.0
942,42,JH Stander (SCOT),2009-2012,11,11,2,2,0,0,2,1 (1ct 0st),0.18100000000000002
943,43,F Stoman (PORT),2019-2019,4,4,2,1,1,1,0,2 (1ct 1st),0.5
944,44,DC Stovell (BMUDA),2019-2019,6,6,2,2,0,0,2,1 (1ct 0st),0.33299999999999996
945,45,GM Strydom (Caym),2019-2019,6,6,2,2,0,0,2,1 (1ct 0st),0.33299999999999996
946,46,JTS Sumerauer (JER),2019-2019,8,8,2,2,0,0,2,1 (1ct 0st),0.25
947,47,K Suttisan (THAI),2019-2019,2,2,2,2,0,0,2,2 (2ct 0st),1.0
948,48,Syed Aziz (MAL),2019-2019,14,13,2,2,0,0,2,1 (1ct 0st),0.153
949,49,Tahir Dar (BAH),2019-2019,4,4,2,2,0,0,2,1 (1ct 0st),0.5
950,0,Tauqeer Hussain (ESP),2019-2019,4,4,2,2,0,0,2,1 (1ct 0st),0.5
951,1,WU Tharanga (SL),2006-2018,26,26,2,2,0,0,2,1 (1ct 0st),0.076
952,2,J Theron (SA),2010-2012,9,9,2,2,0,0,2,1 (1ct 0st),0.222
953,3,RA Thomas (CAN),2019-2019,8,8,2,2,0,0,2,1 (1ct 0st),0.25
954,4,GJ Thompson (IRE),2016-2019,10,10,2,2,0,0,2,1 (1ct 0st),0.2
955,5,T Thushara (SL),2008-2010,6,6,2,2,0,0,2,1 (1ct 0st),0.33299999999999996
956,6,DT Tiripano (ZIM),2016-2019,10,10,2,2,0,0,2,1 (1ct 0st),0.2
957,7,MK Tiwary (INDIA),2011-2012,3,3,2,2,0,0,2,2 (2ct 0st),0.6659999999999999
958,8,JC Tredwell (ENG),2012-2014,17,16,2,2,0,0,2,1 (1ct 0st),0.125
959,9,ME Trescothick (ENG),2005-2006,3,3,2,2,0,0,2,2 (2ct 0st),0.6659999999999999
960,10,T Tshose (Botsw),2019-2019,2,2,2,2,0,0,2,1 (1ct 0st),1.0
961,11,E Ul Haq (NOR),2019-2019,5,5,2,2,0,0,2,1 (1ct 0st),0.4
962,12,Umar Adam (Mald),2019-2019,11,11,2,2,0,0,2,1 (1ct 0st),0.18100000000000002
963,13,RV Uthappa (INDIA),2007-2015,13,12,2,2,0,1,1,1 (1ct 0st),0.166
964,14,R van der Merwe (Arg),2019-2019,5,5,2,2,0,0,2,1 (1ct 0st),0.4
965,15,S Vashisht (ROM),2019-2019,3,3,2,2,0,0,2,1 (1ct 0st),0.6659999999999999
966,16,Vichanath Singh (THAI),2019-2019,4,4,2,2,0,0,2,1 (1ct 0st),0.5
967,17,Vinod Kumar (ESP),2019-2019,3,3,2,2,0,0,2,2 (2ct 0st),0.6659999999999999
968,18,BV Vitori (ZIM),2012-2016,11,11,2,2,0,0,2,1 (1ct 0st),0.18100000000000002
969,19,Waheed Ahmed (UAE),2019-2019,10,10,2,2,0,0,2,1 (1ct 0st),0.2
970,20,SR Welsh (CAN),2008-2008,1,1,2,2,0,0,2,2 (2ct 0st),2.0
971,21,AR White (IRE),2008-2012,18,17,2,2,0,0,2,1 (1ct 0st),0.11699999999999999
972,22,CG Williams (NAM),2019-2019,13,13,2,2,0,0,2,1 (1ct 0st),0.153
973,23,OR Willis (Caym),2019-2019,3,3,2,1,1,0,1,1 (1ct 0st),0.6659999999999999
974,24,C Wright (Caym),2019-2019,6,6,2,2,0,0,2,1 (1ct 0st),0.33299999999999996
975,25,Yasar Haroon (),2019-2019,4,4,2,2,0,0,2,1 (1ct 0st),0.5
976,26,Yusuf Ebrahim (PNM),2019-2019,3,3,2,2,0,0,2,2 (2ct 0st),0.6659999999999999
977,27,Zahoor Khan (UAE),2017-2019,18,18,2,2,0,0,2,1 (1ct 0st),0.111
978,28,C Zhuwao (ZIM),2008-2018,7,7,2,2,0,0,2,1 (1ct 0st),0.285
979,29,Zishan Shah (DEN),2019-2019,6,4,2,2,0,0,2,1 (1ct 0st),0.5
980,30,B Zuiderent (NL),2009-2010,6,6,2,2,0,0,2,1 (1ct 0st),0.33299999999999996
981,31,M Abdulla (MWI),2019-2019,5,5,1,1,0,0,1,1 (1ct 0st),0.2
982,32,Abdul Shakoor (UAE),2015-2019,6,6,1,0,1,0,0,1 (0ct 1st),0.166
983,33,Abdul Wahid (Saudi),2019-2019,5,5,1,1,0,0,1,1 (1ct 0st),0.2
984,34,Abraash Khan (CAN),2019-2019,7,7,1,1,0,0,1,1 (1ct 0st),0.142
985,35,Abrar Bilal (Aut),2019-2019,3,3,1,0,1,0,0,1 (0ct 1st),0.33299999999999996
986,36,Abu Jayed (BDESH),2018-2018,3,3,1,1,0,0,1,1 (1ct 0st),0.33299999999999996
987,37,AR Adams (NZ),2005-2006,4,4,1,1,0,0,1,1 (1ct 0st),0.25
988,38,VD Adewoye (NGA),2019-2019,7,7,1,1,0,0,1,1 (1ct 0st),0.142
989,39,Afsar Zazai (AFG),2013-2013,1,1,1,0,1,0,0,1 (0ct 1st),1.0
990,40,GJ Agius (MALTA),2019-2019,2,2,1,1,0,0,1,1 (1ct 0st),0.5
991,41,P Agnihotri (NOR),2019-2019,2,2,1,1,0,0,1,1 (1ct 0st),0.5
992,42,SA Ahmad (DEN),2019-2019,5,3,1,1,0,0,1,1 (1ct 0st),0.33299999999999996
993,43,Ahmed Hassan (Mald),2019-2019,11,11,1,1,0,0,1,1 (1ct 0st),0.09
994,44,GW Aldridge (NZ),2011-2011,1,1,1,1,0,0,1,1 (1ct 0st),1.0
995,45,Amir Ali (OMAN),2015-2016,10,9,1,1,0,0,1,1 (1ct 0st),0.111
996,46,Amjad Ali (UAE),2014-2015,5,5,1,1,0,0,1,1 (1ct 0st),0.2
997,47,Anam Mollik (ITA),2019-2019,2,2,1,1,0,0,1,1 (1ct 0st),0.5
998,48,Anasim Khan (BAH),2019-2019,4,4,1,1,0,0,1,1 (1ct 0st),0.25
999,49,Aqib Iqbal (Aut),2019-2019,5,5,1,1,0,0,1,1 (1ct 0st),0.2
1000,0,S Arachchige (ITA),2019-2019,4,4,1,1,0,0,1,1 (1ct 0st),0.25
1001,1,Arafat Sunny (BDESH),2014-2016,10,10,1,1,0,0,1,1 (1ct 0st),0.1
1002,2,Aritra Dutta (SGP),2019-2019,8,8,1,1,0,0,1,1 (1ct 0st),0.125
1003,3,P Arora (Mex),2019-2019,2,2,1,1,0,0,1,1 (1ct 0st),0.5
1004,4,U Aryaman Sunil (SGP),2019-2019,2,2,1,1,0,0,1,1 (1ct 0st),0.5
1005,5,Ashiqullah Said (Belg),2019-2019,3,3,1,1,0,0,1,1 (1ct 0st),0.33299999999999996
1006,6,A Ashokan (CZK-R),2019-2019,2,2,1,1,0,0,1,1 (1ct 0st),0.5
1007,7,Aslam Mohammad (),2019-2019,3,3,1,1,0,0,1,1 (1ct 0st),0.33299999999999996
1008,8,SK Atai (PNG),2019-2019,2,2,1,1,0,0,1,1 (1ct 0st),0.5
1009,9,V Ateak (Ghana),2019-2019,4,4,1,1,0,0,1,1 (1ct 0st),0.25
1010,10,Atif Kamal (LUX),2019-2019,4,4,1,1,0,0,1,1 (1ct 0st),0.25
1011,11,MS Aulakh (CAN),2012-2013,3,3,1,1,0,0,1,1 (1ct 0st),0.33299999999999996
1012,12,Avi Dixit (SGP),2019-2019,1,1,1,1,0,0,1,1 (1ct 0st),1.0
1013,13,Awais Malik (QAT),2019-2019,11,11,1,1,0,0,1,1 (1ct 0st),0.09
1014,14,MO Bacarese (GIBR),2019-2019,3,3,1,1,0,0,1,1 (1ct 0st),0.33299999999999996
1015,15,KS Bagabena (Ghana),2019-2019,4,4,1,1,0,0,1,1 (1ct 0st),0.25
1016,16,JD Baker (Samoa),2019-2019,4,4,1,1,0,0,1,1 (1ct 0st),0.25
1017,17,G Bakiweyem (Ghana),2019-2019,3,3,1,1,0,0,1,1 (1ct 0st),0.33299999999999996
1018,18,WD Balaji Rao (CAN),2008-2008,4,4,1,1,0,0,1,1 (1ct 0st),0.25
1019,19,Baljit Singh (ITA),2019-2019,8,7,1,1,0,0,1,1 (1ct 0st),0.142
1020,20,JT Ball (ENG),2018-2018,2,2,1,1,0,0,1,1 (1ct 0st),0.5
1021,21,CT Bancroft (AUS),2016-2016,1,1,1,1,0,1,0,1 (1ct 0st),1.0
1022,22,HMCM Bandara (SL),2006-2009,4,4,1,1,0,0,1,1 (1ct 0st),0.25
1023,23,S Bantzas (),2019-2019,1,1,1,1,0,0,1,1 (1ct 0st),1.0
1024,24,AB Barath (WI),2010-2011,2,2,1,1,0,0,1,1 (1ct 0st),0.5
1025,25,J Barker (LUX),2019-2019,4,4,1,1,0,0,1,1 (1ct 0st),0.25
1026,26,P Baron (Arg),2019-2019,5,5,1,1,0,0,1,1 (1ct 0st),0.2
1027,27,OO Bascome (BMUDA),2008-2019,3,3,1,1,0,0,1,1 (1ct 0st),0.33299999999999996
1028,28,T Bavuma (SA),2019-2019,2,2,1,1,0,0,1,1 (1ct 0st),0.5
1029,29,RL Bhudia (KENYA),2007-2007,3,3,1,1,0,0,1,1 (1ct 0st),0.33299999999999996
1030,30,SR Bhudia (KENYA),2019-2019,4,4,1,1,0,0,1,1 (1ct 0st),0.25
1031,31,Bilawal Bhatti (PAK),2013-2015,9,9,1,1,0,0,1,1 (1ct 0st),0.111
1032,32,TR Birt (AUS),2010-2012,4,4,1,1,0,0,1,1 (1ct 0st),0.25
1033,33,D Bishoo (WI),2011-2019,7,7,1,1,0,0,1,1 (1ct 0st),0.142
1034,34,JAR Blain (SCOT),2007-2008,6,5,1,1,0,0,1,1 (1ct 0st),0.2
1035,35,TA Blundell (NZ),2017-2018,3,3,1,1,0,1,0,1 (1ct 0st),0.33299999999999996
1036,36,SM Boland (AUS),2016-2016,3,3,1,1,0,0,1,1 (1ct 0st),0.33299999999999996
1037,37,SG Borthwick (ENG),2011-2011,1,1,1,1,0,0,1,1 (1ct 0st),1.0
1038,38,LE Bosman (SA),2006-2010,14,14,1,1,0,0,1,1 (1ct 0st),0.071
1039,39,IDR Bradshaw (WI),2006-2006,1,1,1,1,0,0,1,1 (1ct 0st),1.0
1040,40,DR Briggs (ENG),2012-2014,7,6,1,1,0,0,1,1 (1ct 0st),0.166
1041,41,N Buckle (GUE),2019-2019,3,3,1,1,0,0,1,1 (1ct 0st),0.33299999999999996
1042,42,J Bulele (Moz),2019-2019,7,6,1,1,0,0,1,1 (1ct 0st),0.166
1043,43,DE Burgess (Samoa),2019-2019,4,4,1,1,0,0,1,1 (1ct 0st),0.25
1044,44,DK Butler (WI),2006-2006,1,1,1,1,0,0,1,1 (1ct 0st),1.0
1045,45,CL Cairns (NZ),2005-2006,2,2,1,1,0,0,1,1 (1ct 0st),0.5
1046,46,JD Campbell (WI),2019-2019,2,2,1,1,0,0,1,1 (1ct 0st),0.5
1047,47,RJ Campbell (HKG),2016-2016,3,3,1,1,0,0,1,1 (1ct 0st),0.33299999999999996
1048,48,MA Carberry (ENG),2014-2014,1,1,1,1,0,0,1,1 (1ct 0st),1.0
1049,49,NM Carter (SCOT),2013-2013,7,7,1,1,0,0,1,1 (1ct 0st),0.142
1050,0,P Chandran (Mex),2019-2019,3,3,1,1,0,0,1,1 (1ct 0st),0.33299999999999996
1051,1,N Chejay (BHU),2019-2019,1,1,1,1,0,0,1,1 (1ct 0st),1.0
1052,2,TS Chisoro (ZIM),2015-2018,12,12,1,1,0,0,1,1 (1ct 0st),0.083
1053,3,AN Cook (ENG),2007-2009,4,4,1,1,0,0,1,1 (1ct 0st),0.25
1054,4,J Cutinho (CRC),2019-2019,3,3,1,1,0,0,1,1 (1ct 0st),0.33299999999999996
1055,5,DK Dahyabhai Ahir (PNM),2019-2019,2,2,1,1,0,0,1,1 (1ct 0st),0.5
1056,6,JWM Dalrymple (ENG),2006-2007,3,3,1,1,0,0,1,1 (1ct 0st),0.33299999999999996
1057,7,H Dandapani (Fin),2019-2019,5,5,1,1,0,0,1,1 (1ct 0st),0.2
1058,8,K Dasan (),2019-2019,3,3,1,1,0,0,1,1 (1ct 0st),0.33299999999999996
1059,9,AS Dean (CAN),2008-2013,2,2,1,1,0,0,1,1 (1ct 0st),0.5
1060,10,M de Lange (SA),2012-2015,6,6,1,1,0,0,1,1 (1ct 0st),0.166
1061,11,CJ Delany (GIBR),2019-2019,4,4,1,1,0,0,1,1 (1ct 0st),0.25
1062,12,SI de Saram (SL),2009-2009,1,1,1,1,0,0,1,1 (1ct 0st),1.0
1063,13,PC de Silva (SL),2017-2017,2,2,1,1,0,0,1,1 (1ct 0st),0.5
1064,14,Dhiman Ghosh (BDESH),2008-2008,1,1,1,0,1,0,0,1 (0ct 1st),1.0
1065,15,AB Dinda (INDIA),2009-2012,9,9,1,1,0,0,1,1 (1ct 0st),0.111
1066,16,LA Dunbar (Serb),2019-2019,2,2,1,1,0,1,0,1 (1ct 0st),0.5
1067,17,AB Dursak (TKY),2019-2019,4,4,1,1,0,0,1,1 (1ct 0st),0.25
1068,18,G Dutta (Mex),2019-2019,7,7,1,1,0,0,1,1 (1ct 0st),0.142
1069,19,J Edness (BMUDA),2008-2008,3,3,1,0,1,0,0,1 (0ct 1st),0.33299999999999996
1070,20,RMS Eranga (SL),2012-2013,3,3,1,1,0,0,1,1 (1ct 0st),0.33299999999999996
1071,21,L Evile (Samoa),2019-2019,4,4,1,1,0,0,1,1 (1ct 0st),0.25
1072,22,M Faheem (THAI),2019-2019,4,4,1,1,0,0,1,1 (1ct 0st),0.25
1073,23,Faisal Khan (Saudi),2019-2019,4,4,1,1,0,0,1,1 (1ct 0st),0.25
1074,24,Fareed Ahmad (AFG),2016-2019,14,14,1,1,0,0,1,1 (1ct 0st),0.071
1075,25,Farhan Ahmed (UAE),2016-2016,3,3,1,1,0,0,1,1 (1ct 0st),0.33299999999999996
1076,26,Fayyaz Ahmed (UAE),2015-2015,1,1,1,1,0,0,1,1 (1ct 0st),1.0
1077,27,CJ Ferguson (AUS),2009-2009,3,3,1,1,0,0,1,1 (1ct 0st),0.33299999999999996
1078,28,SE Findlay (WI),2008-2008,2,2,1,1,0,0,1,1 (1ct 0st),0.5
1079,29,JA Fitzgerald (GIBR),2019-2019,4,4,1,1,0,0,1,1 (1ct 0st),0.25
1080,30,BT Foakes (ENG),2019-2019,1,1,1,1,0,1,0,1 (1ct 0st),1.0
1081,31,CR Foggo (BMUDA),2008-2008,3,3,1,1,0,0,1,1 (1ct 0st),0.33299999999999996
1082,32,TS Fray (BMUDA),2019-2019,10,10,1,1,0,0,1,1 (1ct 0st),0.1
1083,33,C Fry (LUX),2019-2019,3,3,1,1,0,0,1,1 (1ct 0st),0.33299999999999996
1084,34,R Frylinck (SA),2017-2018,3,3,1,1,0,0,1,1 (1ct 0st),0.33299999999999996
1085,35,ST Gabriel (WI),2013-2013,2,2,1,1,0,0,1,1 (1ct 0st),0.5
1086,36,WT Gavera (PNG),2015-2017,6,6,1,1,0,0,1,1 (1ct 0st),0.166
1087,37,Gershon Yusuf (NGA),2019-2019,1,1,1,1,0,0,1,1 (1ct 0st),1.0
1088,38,MR Gillespie (NZ),2006-2008,11,11,1,1,0,0,1,1 (1ct 0st),0.09
1089,39,R Goodwin (PHI),2019-2019,4,4,1,1,0,0,1,1 (1ct 0st),0.25
1090,40,JOA Gordon (CAN),2013-2019,7,7,1,1,0,0,1,1 (1ct 0st),0.142
1091,41,TG Gordon (CAN),2012-2012,3,3,1,1,0,0,1,1 (1ct 0st),0.33299999999999996
1092,42,K Gore (USA),2019-2019,4,4,1,1,0,0,1,1 (1ct 0st),0.25
1093,43,H Gori (CZK-R),2019-2019,7,7,1,1,0,0,1,1 (1ct 0st),0.142
1094,44,S Goud (CZK-R),2019-2019,1,1,1,1,0,0,1,1 (1ct 0st),1.0
1095,45,AM Guruge (UAE),2014-2015,5,5,1,1,0,0,1,1 (1ct 0st),0.2
1096,46,Hafez Farooq (Peru),2019-2019,4,4,1,1,0,0,1,1 (1ct 0st),0.25
1097,47,OJ Hairs (SCOT),2019-2019,8,8,1,1,0,0,1,1 (1ct 0st),0.125
1098,48,Hamza Dar (ESP),2019-2019,1,1,1,1,0,0,1,1 (1ct 0st),1.0
1099,49,SJ Harmison (ENG),2005-2006,2,2,1,1,0,0,1,1 (1ct 0st),0.5
1100,0,NM Hauritz (AUS),2009-2009,3,3,1,1,0,0,1,1 (1ct 0st),0.33299999999999996
1101,1,ML Hayden (AUS),2005-2007,9,9,1,1,0,0,1,1 (1ct 0st),0.111
1102,2,JR Hazlewood (AUS),2013-2016,7,7,1,1,0,0,1,1 (1ct 0st),0.142
1103,3,MJ Henry (NZ),2014-2017,6,6,1,1,0,0,1,1 (1ct 0st),0.166
1104,4,WW Hinds (WI),2006-2010,5,5,1,1,0,0,1,1 (1ct 0st),0.2
1105,5,GB Hogg (AUS),2006-2014,15,15,1,1,0,0,1,1 (1ct 0st),0.066
1106,6,Z Hoque (THAI),2019-2019,3,3,1,1,0,0,1,1 (1ct 0st),0.33299999999999996
1107,7,JM How (NZ),2007-2008,5,5,1,1,0,0,1,1 (1ct 0st),0.2
1108,8,MG Hunter (GIBR),2019-2019,4,4,1,1,0,0,1,1 (1ct 0st),0.25
1109,9,JJ Huo (Moz),2019-2019,7,6,1,1,0,0,1,1 (1ct 0st),0.166
1110,10,J Hurley (Arg),2019-2019,3,3,1,1,0,0,1,1 (1ct 0st),0.33299999999999996
1111,11,A Husain (Arg),2019-2019,5,5,1,1,0,0,1,1 (1ct 0st),0.2
1112,12,GM Hyde (Blz),2019-2019,3,3,1,1,0,0,1,1 (1ct 0st),0.33299999999999996
1113,13,Ibrahim Nashath (Mald),2019-2019,3,3,1,1,0,0,1,1 (1ct 0st),0.33299999999999996
1114,14,Ibrahim Rizan (Mald),2019-2019,5,5,1,1,0,0,1,1 (1ct 0st),0.2
1115,15,Ibrahim Zadran (AFG),2019-2019,3,3,1,1,0,0,1,1 (1ct 0st),0.33299999999999996
1116,16,AF Ifill (Caym),2019-2019,6,6,1,1,0,0,1,1 (1ct 0st),0.166
1117,17,Iftikhar Ahmed (PAK),2016-2019,6,6,1,1,0,0,1,1 (1ct 0st),0.166
1118,18,Ilyas Ahmed (KUW),2019-2019,6,6,1,1,0,0,1,1 (1ct 0st),0.166
1119,19,Imran Ashraf (QAT),2019-2019,3,3,1,1,0,0,1,1 (1ct 0st),0.33299999999999996
1120,20,Imran Haider (UAE),2016-2019,11,11,1,1,0,0,1,1 (1ct 0st),0.09
1121,21,PJ Ingram (NZ),2010-2010,3,3,1,1,0,0,1,1 (1ct 0st),0.33299999999999996
1122,22,DF Jacobs (THAI),2019-2019,4,4,1,1,0,0,1,1 (1ct 0st),0.25
1123,23,KM Jadhav (INDIA),2015-2017,9,9,1,1,0,0,1,1 (1ct 0st),0.111
1124,24,S Jamil (Belg),2019-2019,3,3,1,1,0,0,1,1 (1ct 0st),0.33299999999999996
1125,25,Jasdeep Singh (USA),2019-2019,4,4,1,1,0,0,1,1 (1ct 0st),0.25
1126,26,Jaspreet Singh (ITA),2019-2019,5,4,1,1,0,0,1,1 (1ct 0st),0.25
1127,27,K Jethi (CAN),2008-2008,5,5,1,1,0,0,1,1 (1ct 0st),0.2
1128,28,J Jojo (DEN),2019-2019,7,5,1,1,0,0,1,1 (1ct 0st),0.2
1129,29,MO Jones (BMUDA),2019-2019,8,8,1,1,0,0,1,1 (1ct 0st),0.125
1130,30,NG Jones (IRE),2010-2012,5,4,1,1,0,0,1,1 (1ct 0st),0.25
1131,31,C Jonker (SA),2018-2018,2,2,1,1,0,0,1,1 (1ct 0st),0.5
1132,32,Junaid Siddique (BDESH),2007-2012,7,7,1,1,0,0,1,1 (1ct 0st),0.142
1133,33,Kaleem Shah (Moz),2019-2019,7,6,1,1,0,0,1,1 (1ct 0st),0.166
1134,34,JK Kamande (KENYA),2007-2010,12,12,1,1,0,0,1,1 (1ct 0st),0.083
1135,35,Kamran Shazad (UAE),2014-2014,3,3,1,1,0,0,1,1 (1ct 0st),0.33299999999999996
1136,36,TE Kane (IRE),2015-2019,7,5,1,1,0,0,1,1 (1ct 0st),0.2
1137,37,S Keshvani (CAN),2010-2010,2,2,1,1,0,0,1,1 (1ct 0st),0.5
1138,38,RWT Key (ENG),2009-2009,1,1,1,1,0,0,1,1 (1ct 0st),1.0
1139,39,N Khanna (MALTA),2019-2019,2,2,1,1,0,0,1,1 (1ct 0st),0.5
1140,40,Khizer Ahmed (NOR),2019-2019,5,5,1,0,1,0,0,1 (0ct 1st),0.2
1141,41,N Khosla (MALTA),2019-2019,4,4,1,1,0,0,1,1 (1ct 0st),0.25
1142,42,Khurram Chohan (CAN),2010-2010,4,4,1,1,0,0,1,1 (1ct 0st),0.25
1143,43,TCR Kimber (GUE),2019-2019,3,3,1,0,1,0,0,1 (0ct 1st),0.33299999999999996
1144,44,NR Kirton (CAN),2019-2019,5,5,1,1,0,0,1,1 (1ct 0st),0.2
1145,45,RK Kleinveldt (SA),2008-2013,6,6,1,1,0,0,1,1 (1ct 0st),0.166
1146,46,Kuldeep Singh (PHI),2019-2019,4,4,1,1,0,0,1,1 (1ct 0st),0.25
1147,47,P Kumar (INDIA),2008-2012,10,10,1,1,0,0,1,1 (1ct 0st),0.1
1148,48,R Kumar (ROM),2019-2019,4,4,1,1,0,0,1,1 (1ct 0st),0.25
1149,49,UKPW Kumaranayaka (KUW),2019-2019,3,3,1,1,0,0,1,1 (1ct 0st),0.33299999999999996
1150,0,A Lagos (),2019-2019,1,1,1,1,0,0,1,1 (1ct 0st),1.0
1151,1,H Lakov (),2019-2019,3,3,1,1,0,0,1,1 (1ct 0st),0.33299999999999996
1152,2,CK Langeveldt (SA),2005-2010,9,9,1,1,0,0,1,1 (1ct 0st),0.111
1153,3,B Laughlin (AUS),2009-2013,3,3,1,1,0,0,1,1 (1ct 0st),0.33299999999999996
1154,4,J Lewis (ENG),2005-2007,2,2,1,1,0,0,1,1 (1ct 0st),0.5
1155,5,ML Lewis (AUS),2006-2006,2,2,1,1,0,0,1,1 (1ct 0st),0.5
1156,6,RN Lewis (WI),2008-2008,1,1,1,1,0,0,1,1 (1ct 0st),1.0
1157,7,NCK Liyanage (MAL),2019-2019,6,5,1,1,0,0,1,1 (1ct 0st),0.2
1158,8,KS Lokuarachchi (SL),2012-2012,2,2,1,1,0,0,1,1 (1ct 0st),0.5
1159,9,J Long (PHI),2019-2019,2,2,1,1,0,0,1,1 (1ct 0st),0.5
1160,10,T Lungameni (NAM),2019-2019,6,6,1,1,0,0,1,1 (1ct 0st),0.166
1161,11,GD McGrath (AUS),2005-2005,2,2,1,1,0,0,1,1 (1ct 0st),0.5
1162,12,NJ Maddinson (AUS),2013-2018,6,6,1,1,0,0,1,1 (1ct 0st),0.166
1163,13,DL Maddy (ENG),2007-2007,4,4,1,1,0,0,1,1 (1ct 0st),0.25
1164,14,Mahedi Hasan (BDESH),2018-2018,1,1,1,1,0,0,1,1 (1ct 0st),1.0
1165,15,Mahmad Data (PNM),2019-2019,2,2,1,1,0,0,1,1 (1ct 0st),0.5
1166,16,S Mahmood (ENG),2019-2019,3,3,1,1,0,0,1,1 (1ct 0st),0.33299999999999996
1167,17,SI Mahmood (ENG),2006-2009,4,4,1,1,0,0,1,1 (1ct 0st),0.25
1168,18,GI Maiden (SCOT),2008-2008,3,3,1,1,0,0,1,1 (1ct 0st),0.33299999999999996
1169,19,BF Mailata (Samoa),2019-2019,4,4,1,1,0,0,1,1 (1ct 0st),0.25
1170,20,GT Main (SCOT),2015-2016,4,2,1,1,0,0,1,1 (1ct 0st),0.5
1171,21,D Maisuria (Botsw),2019-2019,6,6,1,1,0,0,1,1 (1ct 0st),0.166
1172,22,A Makesh (KUW),2019-2019,4,4,1,1,0,0,1,1 (1ct 0st),0.25
1173,23,AK Mandal (NEPAL),2015-2015,2,2,1,1,0,0,1,1 (1ct 0st),0.5
1174,24,Mandeep Singh (INDIA),2016-2016,3,3,1,1,0,0,1,1 (1ct 0st),0.33299999999999996
1175,25,P Manning (Caym),2019-2019,6,6,1,1,0,0,1,1 (1ct 0st),0.166
1176,26,AK Markram (SA),2019-2019,2,2,1,1,0,0,1,1 (1ct 0st),0.5
1177,27,HJH Marshall (NZ),2005-2006,3,3,1,1,0,0,1,1 (1ct 0st),0.33299999999999996
1178,28,OM Marshall (Peru),2019-2019,3,3,1,1,0,0,1,1 (1ct 0st),0.33299999999999996
1179,29,CS Martin (NZ),2007-2008,6,6,1,1,0,0,1,1 (1ct 0st),0.166
1180,30,DR Martyn (AUS),2005-2006,4,4,1,1,0,0,1,1 (1ct 0st),0.25
1181,31,I Master (Botsw),2019-2019,2,2,1,1,0,0,1,1 (1ct 0st),0.5
1182,32,GE Mathurin (WI),2011-2012,3,3,1,1,0,0,1,1 (1ct 0st),0.33299999999999996
1183,33,B Mavuta (ZIM),2018-2018,3,3,1,1,0,0,1,1 (1ct 0st),0.33299999999999996
1184,34,M Meade (Chile),2019-2019,1,1,1,1,0,0,1,1 (1ct 0st),1.0
1185,35,SC Meaker (ENG),2012-2012,2,2,1,1,0,0,1,1 (1ct 0st),0.5
1186,36,J Mees (LUX),2019-2019,3,3,1,1,0,1,0,1 (1ct 0st),0.33299999999999996
1187,37,PHKD Mendis (SL),2018-2019,4,4,1,1,0,0,1,1 (1ct 0st),0.25
1188,38,CAJ Meschede (GER),2019-2019,5,5,1,1,0,0,1,1 (1ct 0st),0.2
1189,39,KO Meth (ZIM),2012-2012,2,2,1,1,0,0,1,1 (1ct 0st),0.5
1190,40,Mian Mehmood (PORT),2019-2019,4,4,1,1,0,0,1,1 (1ct 0st),0.25
1191,41,AJ Michael (Samoa),2019-2019,4,4,1,1,0,0,1,1 (1ct 0st),0.25
1192,42,TS Mills (ENG/ICC),2016-2018,5,5,1,1,0,0,1,1 (1ct 0st),0.2
1193,43,A Mishra (INDIA),2010-2017,10,10,1,1,0,0,1,1 (1ct 0st),0.1
1194,44,P Mishra (),2019-2019,3,3,1,1,0,0,1,1 (1ct 0st),0.33299999999999996
1195,45,K Modise (Botsw),2019-2019,3,3,1,1,0,0,1,1 (1ct 0st),0.33299999999999996
1196,46,Mohammad Irfan (PAK),2012-2019,22,22,1,1,0,0,1,1 (1ct 0st),0.045
1197,47,Mohammad Kashif (NL),2010-2010,3,3,1,1,0,0,1,1 (1ct 0st),0.33299999999999996
1198,48,Mohammad Shahzad (UAE),2015-2017,20,20,1,1,0,0,1,1 (1ct 0st),0.05
1199,49,Mohammad Tauqir (UAE),2015-2015,3,3,1,1,0,0,1,1 (1ct 0st),0.33299999999999996
1200,0,Mohammad Yousuf (PAK),2006-2010,3,3,1,1,0,0,1,1 (1ct 0st),0.33299999999999996
1201,1,JN Mohammed (WI),2017-2018,9,9,1,1,0,0,1,1 (1ct 0st),0.111
1202,2,Mohammed Qasim (UAE),2016-2017,3,3,1,1,0,0,1,1 (1ct 0st),0.33299999999999996
1203,3,Mohammed Siraj (INDIA),2017-2018,3,3,1,1,0,0,1,1 (1ct 0st),0.33299999999999996
1204,4,HJC Mol (NL),2008-2008,4,3,1,1,0,0,1,1 (1ct 0st),0.33299999999999996
1205,5,Mominul Haque (BDESH),2012-2014,6,6,1,1,0,0,1,1 (1ct 0st),0.166
1206,6,D Mongia (INDIA),2006-2006,1,1,1,1,0,0,1,1 (1ct 0st),1.0
1207,7,M Mooketsi (Botsw),2019-2019,7,7,1,1,0,0,1,1 (1ct 0st),0.142
1208,8,Mudassar Muhammad (GER),2019-2019,7,7,1,1,0,0,1,1 (1ct 0st),0.142
1209,9,Muhamad Syahadat (MAL),2019-2019,10,9,1,1,0,0,1,1 (1ct 0st),0.111
1210,10,Muhammad Amir (MAL),2019-2019,1,1,1,1,0,0,1,1 (1ct 0st),1.0
1211,11,Muhammad Asjed (ESP),2019-2019,2,2,1,1,0,0,1,1 (1ct 0st),0.5
1212,12,Muhammad Kaleem (UAE),2016-2016,9,9,1,1,0,0,1,1 (1ct 0st),0.111
1213,13,Muhammad Khurram (MWI),2019-2019,5,5,1,1,0,1,0,1 (1ct 0st),0.2
1214,14,Muhammad Naeem (Saudi),2019-2019,5,5,1,1,0,0,1,1 (1ct 0st),0.2
1215,15,Muhammad Saleem (),2019-2019,4,4,1,1,0,0,1,1 (1ct 0st),0.25
1216,16,JK Mukhiya (NEPAL),2014-2015,4,4,1,1,0,0,1,1 (1ct 0st),0.25
1217,17,EMDY Munaweera (SL),2012-2017,13,13,1,1,0,0,1,1 (1ct 0st),0.076
1218,18,GBW Munaweera (QAT),2019-2019,5,5,1,1,0,0,1,1 (1ct 0st),0.2
1219,19,Munir Dar (HKG),2014-2014,2,2,1,1,0,0,1,1 (1ct 0st),0.5
1220,20,M Muralitharan (SL),2006-2010,12,12,1,1,0,0,1,1 (1ct 0st),0.083
1221,21,D Murphy (SCOT),2013-2013,4,4,1,1,0,1,0,1 (1ct 0st),0.25
1222,22,Musawar Shah (QAT),2019-2019,2,2,1,1,0,0,1,1 (1ct 0st),0.5
1223,23,N M'shangwe (ZIM),2013-2014,5,5,1,1,0,0,1,1 (1ct 0st),0.2
1224,24,AK Muslar (Blz),2019-2019,3,3,1,1,0,0,1,1 (1ct 0st),0.33299999999999996
1225,25,Muslim Yar (GER),2019-2019,7,7,1,1,0,0,1,1 (1ct 0st),0.142
1226,26,T Muzarabani (ZIM),2015-2016,9,9,1,1,0,0,1,1 (1ct 0st),0.111
1227,27,M Mwamadi (MWI),2019-2019,3,3,1,1,0,0,1,1 (1ct 0st),0.33299999999999996
1228,28,Najjam Shahzad (PORT),2019-2019,4,4,1,1,0,0,1,1 (1ct 0st),0.25
1229,29,DM Nakrani (UGA),2019-2019,4,4,1,1,0,0,1,1 (1ct 0st),0.25
1230,30,W Nalisa (VAN),2019-2019,9,9,1,1,0,0,1,1 (1ct 0st),0.111
1231,31,DP Nannes (AUS/NL),2009-2010,17,17,1,1,0,0,1,1 (1ct 0st),0.057999999999999996
1232,32,Naseem Khushi (OMAN),2017-2019,10,10,1,1,0,0,1,1 (1ct 0st),0.1
1233,33,A Nathwani (Aut),2019-2019,5,5,1,1,0,0,1,1 (1ct 0st),0.2
1234,34,A Natubhai Ahir (PNM),2019-2019,3,3,1,1,0,0,1,1 (1ct 0st),0.33299999999999996
1235,35,Naveed Ahmed (CZK-R),2019-2019,7,7,1,1,0,0,1,1 (1ct 0st),0.142
1236,36,Nazakat Ali (NOR),2019-2019,2,2,1,1,0,0,1,1 (1ct 0st),0.5
1237,37,Nazril Rahman (MAL),2019-2019,7,7,1,1,0,0,1,1 (1ct 0st),0.142
1238,38,A Nel (SA),2005-2007,2,2,1,1,0,0,1,1 (1ct 0st),0.5
1239,39,JD Nel (SCOT),2007-2010,10,9,1,1,0,0,1,1 (1ct 0st),0.111
1240,40,L Ngidi (SA),2017-2018,7,7,1,1,0,0,1,1 (1ct 0st),0.142
1241,41,PA Nixon (ENG),2007-2007,1,1,1,0,1,0,0,1 (0ct 1st),1.0
1242,42,L Nussbaumer (GUE),2019-2019,1,1,1,1,0,0,1,1 (1ct 0st),1.0
1243,43,SH Obed (VAN),2019-2019,12,12,1,1,0,0,1,1 (1ct 0st),0.083
1244,44,E Ochieng (KENYA),2019-2019,2,2,1,1,0,0,1,1 (1ct 0st),0.5
1245,45,PP Ojha (INDIA),2009-2010,6,6,1,1,0,0,1,1 (1ct 0st),0.166
1246,46,SNJ O'Keefe (AUS),2010-2011,7,7,1,1,0,0,1,1 (1ct 0st),0.142
1247,47,IO Okpe (NGA),2019-2019,8,8,1,1,0,0,1,1 (1ct 0st),0.125
1248,48,R Olipa (UGA),2019-2019,2,2,1,1,0,0,1,1 (1ct 0st),0.5
1249,49,Omar Hayat (DEN),2019-2019,2,2,1,1,0,0,1,1 (1ct 0st),0.5
1250,0,A Otwani (UGA),2019-2019,4,4,1,1,0,1,0,1 (1ct 0st),0.25
1251,1,SD Outerbridge (BMUDA),2008-2008,3,3,1,1,0,0,1,1 (1ct 0st),0.33299999999999996
1252,2,E Packard (GIBR),2019-2019,4,4,1,1,0,0,1,1 (1ct 0st),0.25
1253,3,K Pala (PNG),2015-2015,2,2,1,1,0,0,1,1 (1ct 0st),0.5
1254,4,I Pandey (NEPAL),2019-2019,4,4,1,1,0,0,1,1 (1ct 0st),0.25
1255,5,NMS Param (SGP),2019-2019,8,8,1,1,0,0,1,1 (1ct 0st),0.125
1256,6,PA Patel (INDIA),2011-2011,2,2,1,1,0,1,0,1 (1ct 0st),0.5
1257,7,RN Patel (KENYA),2019-2019,2,2,1,1,0,0,1,1 (1ct 0st),0.5
1258,8,D Paterson (SA),2017-2018,8,8,1,1,0,0,1,1 (1ct 0st),0.125
1259,9,C Pengkumta (THAI),2019-2019,4,4,1,1,0,0,1,1 (1ct 0st),0.25
1260,10,AK Perera (SL),2013-2019,6,6,1,1,0,0,1,1 (1ct 0st),0.166
1261,11,SL Perera (Ghana),2019-2019,2,2,1,1,0,0,1,1 (1ct 0st),0.5
1262,12,WKD Perkins (WI),2008-2008,1,1,1,1,0,0,1,1 (1ct 0st),1.0
1263,13,J Perman (ESP),2019-2019,2,2,1,1,0,0,1,1 (1ct 0st),0.5
1264,14,AN Petersen (SA),2010-2010,2,2,1,1,0,0,1,1 (1ct 0st),0.5
1265,15,VD Philander (SA),2007-2007,7,7,1,1,0,0,1,1 (1ct 0st),0.142
1266,16,K Pierre (WI),2018-2019,8,8,1,1,0,0,1,1 (1ct 0st),0.125
1267,17,R Pillai (GER),2019-2019,6,6,1,1,0,0,1,1 (1ct 0st),0.166
1268,18,R Pisal (ROM),2019-2019,1,1,1,1,0,0,1,1 (1ct 0st),1.0
1269,19,S Pokhriyal (CZK-R),2019-2019,5,5,1,1,0,0,1,1 (1ct 0st),0.2
1270,20,KOA Powell (WI),2014-2014,1,1,1,1,0,0,1,1 (1ct 0st),1.0
1271,21,M Pushpakumara (SL),2009-2009,1,1,1,1,0,0,1,1 (1ct 0st),1.0
1272,22,A Rangaswamy (Botsw),2019-2019,4,4,1,1,0,0,1,1 (1ct 0st),0.25
1273,23,Raqibul Hasan (BDESH),2008-2010,5,5,1,1,0,0,1,1 (1ct 0st),0.2
1274,24,Raza Iqbal (NOR),2019-2019,5,5,1,1,0,0,1,1 (1ct 0st),0.2
1275,25,CMW Read (ENG),2006-2006,1,1,1,1,0,1,0,1 (1ct 0st),1.0
1276,26,FL Reifer (WI),2009-2009,1,1,1,1,0,0,1,1 (1ct 0st),1.0
1277,27,JB Reva (PNG),2015-2019,9,9,1,1,0,0,1,1 (1ct 0st),0.111
1278,28,KAJ Roach (WI),2008-2012,11,11,1,1,0,0,1,1 (1ct 0st),0.09
1279,29,IH Romaine (BMUDA),2008-2008,2,2,1,1,0,0,1,1 (1ct 0st),0.5
1280,30,Rubel Hossain (BDESH),2009-2018,27,26,1,1,0,0,1,1 (1ct 0st),0.038
1281,31,Rumman Raees (PAK),2016-2018,8,8,1,1,0,0,1,1 (1ct 0st),0.125
1282,32,RJMGM Rupasinghe (SL),2009-2009,2,2,1,1,0,0,1,1 (1ct 0st),0.5
1283,33,GR Russ (PHI),2019-2019,3,3,1,1,0,0,1,1 (1ct 0st),0.33299999999999996
1284,34,HD Rutherford (NZ),2013-2019,8,8,1,1,0,0,1,1 (1ct 0st),0.125
1285,35,SE Rutherford (WI),2018-2019,3,3,1,1,0,0,1,1 (1ct 0st),0.33299999999999996
1286,36,Saad Nasim (PAK),2014-2014,3,3,1,1,0,0,1,1 (1ct 0st),0.33299999999999996
1287,37,VM Sachdev (PNM),2019-2019,2,2,1,1,0,0,1,1 (1ct 0st),0.5
1288,38,Sadeeq Khan (ROM),2019-2019,3,3,1,1,0,0,1,1 (1ct 0st),0.33299999999999996
1289,39,Sahir Naqash (GER),2019-2019,7,7,1,1,0,0,1,1 (1ct 0st),0.142
1290,40,NA Saini (INDIA),2019-2019,5,5,1,1,0,0,1,1 (1ct 0st),0.2
1291,41,Sajedul Islam (BDESH),2013-2013,1,1,1,1,0,0,1,1 (1ct 0st),1.0
1292,42,AM Samad (CAN),2008-2010,7,7,1,1,0,0,1,1 (1ct 0st),0.142
1293,43,SV Samson (INDIA),2015-2015,1,1,1,1,0,0,1,1 (1ct 0st),1.0
1294,44,R Sandaruwan (KUW),2019-2019,10,10,1,1,0,0,1,1 (1ct 0st),0.1
1295,45,JRMVB Sanjaya (SL),2017-2017,8,8,1,1,0,0,1,1 (1ct 0st),0.125
1296,46,K Santokie (WI),2011-2014,12,12,1,1,0,0,1,1 (1ct 0st),0.083
1297,47,Saqlain Arshad (QAT),2019-2019,2,2,1,1,0,0,1,1 (1ct 0st),0.5
1298,48,M Sarenac (Serb),2019-2019,2,2,1,1,0,0,1,1 (1ct 0st),0.5
1299,49,A Sarma (GER),2019-2019,3,3,1,1,0,0,1,1 (1ct 0st),0.33299999999999996
1300,0,MM Sarwar (KUW),2019-2019,5,5,1,1,0,0,1,1 (1ct 0st),0.2
1301,1,I Sawmy (DEN),2019-2019,2,2,1,1,0,0,1,1 (1ct 0st),0.5
1302,2,Sayed Shirzad (AFG),2015-2019,4,4,1,1,0,0,1,1 (1ct 0st),0.25
1303,3,CP Schofield (ENG),2007-2007,4,4,1,1,0,0,1,1 (1ct 0st),0.25
1304,4,Shaffeq Muhammad (),2019-2019,2,2,1,1,0,0,1,1 (1ct 0st),0.5
1305,5,Shafiul Islam (BDESH),2010-2019,17,17,1,1,0,0,1,1 (1ct 0st),0.057999999999999996
1306,6,Shaheen Shah Afridi (PAK),2018-2019,10,10,1,1,0,0,1,1 (1ct 0st),0.1
1307,7,Shaheryar Butt (Belg),2019-2019,3,3,1,1,0,0,1,1 (1ct 0st),0.33299999999999996
1308,8,Shahid Wasif (HKG),2016-2019,9,9,1,1,0,0,1,1 (1ct 0st),0.111
1309,9,Shahriar Nafees (BDESH),2006-2006,1,1,1,1,0,0,1,1 (1ct 0st),1.0
1310,10,A Shahzad (ENG),2010-2011,3,3,1,1,0,0,1,1 (1ct 0st),0.33299999999999996
1311,11,Shamsudheen Purat (Saudi),2019-2019,3,3,1,1,0,0,1,1 (1ct 0st),0.33299999999999996
1312,12,JNK Shannon (IRE),2013-2018,8,8,1,1,0,0,1,1 (1ct 0st),0.125
1313,13,Sharafuddin Ashraf (AFG),2015-2019,8,8,1,1,0,0,1,1 (1ct 0st),0.125
1314,14,MM Sharma (INDIA),2014-2015,8,8,1,1,0,0,1,1 (1ct 0st),0.125
1315,15,V Shetty (UAE),2014-2014,2,2,1,1,0,0,1,1 (1ct 0st),0.5
1316,16,Shoaib Khan jnr (PAK),2008-2008,4,4,1,1,0,0,1,1 (1ct 0st),0.25
1317,17,Shuvagata Hom (BDESH),2016-2016,5,5,1,1,0,0,1,1 (1ct 0st),0.2
1318,18,EHSN Silva (UAE),2014-2014,2,2,1,1,0,0,1,1 (1ct 0st),0.5
1319,19,KRP Silva (USA),2019-2019,2,2,1,1,0,0,1,1 (1ct 0st),0.5
1320,20,M Simpson-Parker (Aut),2019-2019,3,3,1,1,0,0,1,1 (1ct 0st),0.33299999999999996
1321,21,J Singye (BHU),2019-2019,2,2,1,1,0,0,1,1 (1ct 0st),0.5
1322,22,DS Smith (WI),2007-2009,6,6,1,1,0,0,1,1 (1ct 0st),0.166
1323,23,SJS Smith (SCOT),2010-2012,5,5,1,0,1,0,0,1 (0ct 1st),0.2
1324,24,J Smits (NL),2008-2009,6,5,1,1,0,1,0,1 (1ct 0st),0.2
1325,25,JT Smuts (SA),2017-2018,8,8,1,1,0,0,1,1 (1ct 0st),0.125
1326,26,JN Snape (ENG),2007-2007,1,1,1,1,0,0,1,1 (1ct 0st),1.0
1327,27,CB Sole (SCOT),2017-2018,4,4,1,1,0,0,1,1 (1ct 0st),0.25
1328,28,A Srivastav (Chile),2019-2019,4,4,1,1,0,0,1,1 (1ct 0st),0.25
1329,29,ACF Stokes (GUE),2019-2019,7,7,1,1,0,0,1,1 (1ct 0st),0.142
1330,30,AJ Strauss (ENG),2005-2009,4,4,1,1,0,0,1,1 (1ct 0st),0.25
1331,31,R Strydom (IRE),2008-2008,4,3,1,1,0,0,1,1 (1ct 0st),0.33299999999999996
1332,32,Sufyan Mehmood (OMAN),2015-2019,3,3,1,1,0,0,1,1 (1ct 0st),0.33299999999999996
1333,33,P Syafiq Ali (MAL),2019-2019,2,1,1,1,0,0,1,1 (1ct 0st),1.0
1334,34,Syed Rasel (BDESH),2007-2008,8,8,1,1,0,0,1,1 (1ct 0st),0.125
1335,35,Tanveer Ahmed (HKG),2016-2017,5,5,1,1,0,0,1,1 (1ct 0st),0.2
1336,36,Taskin Ahmed (BDESH),2014-2018,19,17,1,1,0,0,1,1 (1ct 0st),0.057999999999999996
1337,37,P Taylor (CZK-R),2019-2019,7,7,1,1,0,0,1,1 (1ct 0st),0.142
1338,38,T Taylor (Caym),2019-2019,6,6,1,1,0,0,1,1 (1ct 0st),0.166
1339,39,SR Tendulkar (INDIA),2006-2006,1,1,1,1,0,0,1,1 (1ct 0st),1.0
1340,40,SP Terry (IRE),2016-2016,1,1,1,1,0,0,1,1 (1ct 0st),1.0
1341,41,DC Thomas (WI),2009-2013,3,3,1,0,1,0,0,1 (0ct 1st),0.33299999999999996
1342,42,S Tobgay (BHU),2019-2019,2,2,1,1,0,0,1,1 (1ct 0st),0.5
1343,43,GC Tonge (WI),2009-2009,1,1,1,1,0,0,1,1 (1ct 0st),1.0
1344,44,RJW Topley (ENG),2015-2016,6,6,1,1,0,0,1,1 (1ct 0st),0.166
1345,45,A Tripathi (Mex),2019-2019,3,3,1,1,0,0,1,1 (1ct 0st),0.33299999999999996
1346,46,LL Tsotsobe (SA),2009-2014,23,23,1,1,0,0,1,1 (1ct 0st),0.043
1347,47,JJ Tucker (BMUDA),2019-2019,5,5,1,1,0,0,1,1 (1ct 0st),0.2
1348,48,S Tyagi (INDIA),2009-2009,1,1,1,1,0,0,1,1 (1ct 0st),1.0
1349,49,A Uniyal (Chile),2019-2019,3,3,1,1,0,0,1,1 (1ct 0st),0.33299999999999996
1350,0,Usama Master (MWI),2019-2019,6,6,1,1,0,0,1,1 (1ct 0st),0.166
1351,1,Usman Ali (Saudi),2019-2019,5,5,1,1,0,0,1,1 (1ct 0st),0.2
1352,2,Usman Limbada (CAN),2010-2013,7,7,1,1,0,0,1,1 (1ct 0st),0.142
1353,3,Usman Shinwari (PAK),2013-2019,16,16,1,1,0,0,1,1 (1ct 0st),0.062
1354,4,Usman Waheed (KUW),2019-2019,6,6,1,1,0,0,1,1 (1ct 0st),0.166
1355,5,JDF Vandersay (SL),2015-2019,10,10,1,1,0,0,1,1 (1ct 0st),0.1
1356,6,MB van Schelven (NL),2015-2015,2,2,1,1,0,0,1,1 (1ct 0st),0.5
1357,7,TCW Veillard (GUE),2019-2019,4,4,1,1,0,0,1,1 (1ct 0st),0.25
1358,8,S Vijayakumar (SGP),2019-2019,9,9,1,1,0,0,1,1 (1ct 0st),0.111
1359,9,Vimal Kumar (PHI),2019-2019,2,2,1,1,0,0,1,1 (1ct 0st),0.5
1360,10,R Vinay Kumar (INDIA),2010-2013,9,9,1,1,0,0,1,1 (1ct 0st),0.111
1361,11,L Vincent (NZ),2006-2007,9,9,1,1,0,0,1,1 (1ct 0st),0.111
1362,12,W Viraliliu (VAN),2019-2019,10,10,1,1,0,0,1,1 (1ct 0st),0.1
1363,13,Vishal Ahir (PNM),2019-2019,1,1,1,1,0,0,1,1 (1ct 0st),1.0
1364,14,KDK Vithanage (SL),2014-2016,3,3,1,1,0,0,1,1 (1ct 0st),0.33299999999999996
1365,15,Waqar Khan (Peru),2019-2019,4,4,1,1,0,0,1,1 (1ct 0st),0.25
1366,16,Waqas Ali (Belg),2019-2019,2,2,1,1,0,0,1,1 (1ct 0st),0.5
1367,17,Washeem Abbas (MALTA),2019-2019,2,2,1,1,0,0,1,1 (1ct 0st),0.5
1368,18,VS Wategaonkar (OMAN),2016-2016,2,2,1,1,0,0,1,1 (1ct 0st),0.5
1369,19,RM West (IRE),2009-2009,5,5,1,1,0,0,1,1 (1ct 0st),0.2
1370,20,AA Westphal (Mex),2019-2019,5,5,1,1,0,0,1,1 (1ct 0st),0.2
1371,21,BTJ Wheal (SCOT),2016-2017,5,5,1,1,0,0,1,1 (1ct 0st),0.2
1372,22,BM Wheeler (NZ),2017-2018,6,6,1,1,0,0,1,1 (1ct 0st),0.166
1373,23,S Wickramasekara (CZK-R),2019-2019,5,5,1,1,0,0,1,1 (1ct 0st),0.2
1374,24,SA Wijeyeratne (CAN),2019-2019,2,2,1,1,0,0,1,1 (1ct 0st),0.5
1375,25,JD Wildermuth (AUS),2018-2018,2,2,1,1,0,0,1,1 (1ct 0st),0.5
1376,26,CR Woakes (ENG),2011-2015,8,8,1,1,0,0,1,1 (1ct 0st),0.125
1377,27,LJ Woodcock (NZ),2010-2011,3,3,1,1,0,0,1,1 (1ct 0st),0.33299999999999996
1378,28,GH Worker (NZ),2015-2015,2,2,1,1,0,0,1,1 (1ct 0st),0.5
1379,29,AS Wright (GUE),2019-2019,8,8,1,1,0,0,1,1 (1ct 0st),0.125
1380,30,CM Wright (SCOT),2007-2009,3,2,1,1,0,0,1,1 (1ct 0st),0.5
1381,31,HN Ya France (NAM),2019-2019,6,6,1,1,0,0,1,1 (1ct 0st),0.166
1382,32,Yasar Idrees (KUW),2019-2019,1,1,1,1,0,0,1,1 (1ct 0st),1.0
1383,33,Yasir Arafat (PAK),2007-2012,13,13,1,1,0,0,1,1 (1ct 0st),0.076
1384,34,Zaheer Maqsood (UAE),2015-2016,3,3,1,1,0,0,1,1 (1ct 0st),0.33299999999999996
1385,35,Zahid Hussain (CAN),2012-2012,3,3,1,1,0,0,1,1 (1ct 0st),0.33299999999999996
1386,36,Zameer Khan (DEN),2019-2019,2,2,1,1,0,0,1,1 (1ct 0st),0.5
1387,37,A Zampa (AUS),2016-2019,27,26,1,1,0,0,1,1 (1ct 0st),0.038
1388,38,C Zavoiu (ROM),2019-2019,3,3,1,1,0,0,1,1 (1ct 0st),0.33299999999999996
1389,39,Zawar Farid (UAE),2019-2019,4,4,1,1,0,0,1,1 (1ct 0st),0.25
1390,40,Zeeshan Abbas (BAH),2019-2019,1,1,1,1,0,0,1,1 (1ct 0st),1.0
1391,41,Zubaidi Zulkifle (MAL),2019-2019,4,4,1,1,0,0,1,1 (1ct 0st),0.25
1392,42,Zulfiqar Babar (PAK),2013-2014,7,7,1,1,0,0,1,1 (1ct 0st),0.142
1393,43,Zulqarnain Haider (PAK),2007-2010,3,3,1,0,1,0,0,1 (0ct 1st),0.33299999999999996
1394,44,Zulqarnain Haider (ESP),2019-2019,5,5,1,1,0,0,1,1 (1ct 0st),0.2
1395,45,Aamer Ikram (PORT),2019-2019,4,4,0,0,0,0,0,0,0.0
1396,46,Aamer Yamin (PAK),2015-2018,2,2,0,0,0,0,0,0,0.0
1397,47,Aaron Jones (USA),2019-2019,8,8,0,0,0,0,0,0,0.0
1398,48,Z Abbasi (Botsw),2019-2019,1,1,0,0,0,0,0,0,0.0
1399,49,Abbas Saad (Saudi),2019-2019,2,2,0,0,0,0,0,0,0.0
1400,0,YA Abdulla (SA),2009-2009,2,2,0,0,0,0,0,0,0.0
1401,1,Abdullah Mahmood (DEN),2019-2019,1,1,0,0,0,0,0,0,0.0
1402,2,Abdullah Sheikh (NOR),2019-2019,2,2,0,0,0,0,0,0,0.0
1403,3,Abdul Rashid (Belg),2019-2019,1,1,0,0,0,0,0,0,0.0
1404,4,Abdur Rauf (PAK),2008-2008,1,1,0,0,0,0,0,0,0.0
1405,5,M Aboagye (Ghana),2019-2019,3,3,0,0,0,0,0,0,0.0
1406,6,RA Abolarin (NGA),2019-2019,1,1,0,0,0,0,0,0,0.0
1407,7,Abul Hasan (BDESH),2012-2018,5,5,0,0,0,0,0,0,0.0
1408,8,AG Achar (SGP),2019-2019,3,3,0,0,0,0,0,0,0.0
1409,9,F Achelam (UGA),2019-2019,1,1,0,0,0,0,0,0,0.0
1410,10,Adil Hanif (BAH),2019-2019,4,4,0,0,0,0,0,0,0.0
1411,11,Adnan Mufti (UAE),2017-2017,1,1,0,0,0,0,0,0,0.0
1412,12,N Advani (GIBR),2019-2019,1,1,0,0,0,0,0,0,0.0
1413,13,Aftab Ahmed (2) (DEN),2019-2019,1,1,0,0,0,0,0,0,0.0
1414,14,AB Agarkar (INDIA),2006-2007,4,3,0,0,0,0,0,0,0.0
1415,15,A Ahmadhel (),2019-2019,3,3,0,0,0,0,0,0,0.0
1416,16,RI Ahmed (NL),2015-2015,2,2,0,0,0,0,0,0,0.0
1417,17,Ahmed Wardak (GER),2019-2019,9,9,0,0,0,0,0,0,0.0
1418,18,Ahsan Abbasi (HKG),2019-2019,6,6,0,0,0,0,0,0,0.0
1419,19,Ainool Hafizs (MAL),2019-2019,3,3,0,0,0,0,0,0,0.0
1420,20,Aizaz Cheema (PAK),2011-2012,5,5,0,0,0,0,0,0,0.0
1421,21,D Ajekun (NGA),2019-2019,6,6,0,0,0,0,0,0,0.0
1422,22,C Akyuz (TKY),2019-2019,2,2,0,0,0,0,0,0,0.0
1423,23,Ali Ivan (Mald),2019-2019,1,1,0,0,0,0,0,0,0.0
1424,24,Ali Naqi (PORT),2019-2019,4,4,0,0,0,0,0,0,0.0
1425,25,J Allen (),2019-2019,2,2,0,0,0,0,0,0,0.0
1426,26,HS Alta (TKY),2019-2019,4,4,0,0,0,0,0,0,0.0
1427,27,Ameel Mauroof (Mald),2019-2019,10,10,0,0,0,0,0,0,0.0
1428,28,Ameer Saiyed (Botsw),2019-2019,4,4,0,0,0,0,0,0,0.0
1429,29,Aminul Islam (BDESH),2019-2019,4,4,0,0,0,0,0,0,0.0
1430,30,Amir Hayat (UAE),2018-2019,4,4,0,0,0,0,0,0,0.0
1431,31,Amir Hamza (AFG),2013-2017,31,31,0,0,0,0,0,0,0.0
1432,32,Ammad Uddin (BAH),2019-2019,4,4,0,0,0,0,0,0,0.0
1433,33,Anas Khan (HKG),2014-2014,1,1,0,0,0,0,0,0,0.0
1434,34,J Anderson (IRE),2015-2015,4,2,0,0,0,0,0,0,0.0
1435,35,DK Anefie (Ghana),2019-2019,4,4,0,0,0,0,0,0,0.0
1436,36,A Anemogiannis (),2019-2019,1,1,0,0,0,0,0,0,0.0
1437,37,B Angeltti (Arg),2019-2019,3,3,0,0,0,0,0,0,0.0
1438,38,DNA Ankrah (Ghana),2019-2019,4,4,0,0,0,0,0,0,0.0
1439,39,M Ansari (OMAN),2015-2016,11,10,0,0,0,0,0,0,0.0
1440,40,Ansar Iqbal (NOR),2019-2019,4,4,0,0,0,0,0,0,0.0
1441,41,MA Aponso (SL),2018-2018,3,3,0,0,0,0,0,0,0.0
1442,42,Apon Mustafizur (Serb),2019-2019,2,2,0,0,0,0,0,0,0.0
1443,43,S Appu (MALTA),2019-2019,4,4,0,0,0,0,0,0,0.0
1444,44,S Aravind (INDIA),2015-2015,1,1,0,0,0,0,0,0,0.0
1445,45,JC Archer (ENG),2019-2019,1,1,0,0,0,0,0,0,0.0
1446,46,Z Arinaitwe (UGA),2019-2019,3,3,0,0,0,0,0,0,0.0
1447,47,RP Arnold (SL),2006-2006,1,1,0,0,0,0,0,0,0.0
1448,48,B Arora (MALTA),2019-2019,4,4,0,0,0,0,0,0,0.0
1449,49,Arsalan Arif (Aut),2019-2019,2,2,0,0,0,0,0,0,0.0
1450,0,Arsalan Qadir (CAN),2010-2010,1,1,0,0,0,0,0,0,0.0
1451,1,Arshad Hayat (CZK-R),2019-2019,6,6,0,0,0,0,0,0,0.0
1452,2,Arslan Ahmed (PORT),2019-2019,3,3,0,0,0,0,0,0,0.0
1453,3,Arslan Ahmed (),2019-2019,3,3,0,0,0,0,0,0,0.0
1454,4,Asad Ali (PAK),2013-2013,2,2,0,0,0,0,0,0,0.0
1455,5,A Aspiotis (),2019-2019,3,3,0,0,0,0,0,0,0.0
1456,6,MS Atapattu (SL),2006-2006,2,2,0,0,0,0,0,0,0.0
1457,7,S Ateak (Ghana),2019-2019,3,3,0,0,0,0,0,0,0.0
1458,8,Atif Ali Khan (UAE),2016-2016,1,1,0,0,0,0,0,0,0.0
1459,9,Atif Mehmood (ESP),2019-2019,9,9,0,0,0,0,0,0,0.0
1460,10,R Avery (),2019-2019,4,4,0,0,0,0,0,0,0.0
1461,11,Awais Zia (PAK),2012-2014,5,5,0,0,0,0,0,0,0.0
1462,12,P Awana (INDIA),2012-2012,2,2,0,0,0,0,0,0,0.0
1463,13,Aziz Mohammad (Belg),2019-2019,3,3,0,0,0,0,0,0,0.0
1464,14,Azyan Farhath (Mald),2019-2019,2,2,0,0,0,0,0,0,0.0
1465,15,S Badrinath (INDIA),2011-2011,1,1,0,0,0,0,0,0,0.0
1466,16,LS Baker (WI),2008-2009,3,3,0,0,0,0,0,0,0.0
1467,17,R Bakum (Ghana),2019-2019,4,4,0,0,0,0,0,0,0.0
1468,18,L Balaji (INDIA),2012-2012,5,5,0,0,0,0,0,0,0.0
1469,19,KMC Bandara (SL),2016-2016,1,1,0,0,0,0,0,0,0.0
1470,20,HH Banner (Blz),2019-2019,3,3,0,0,0,0,0,0,0.0
1471,21,TC Barker (LUX),2019-2019,4,4,0,0,0,0,0,0,0.0
1472,22,MC Bascombe (WI),2011-2011,1,1,0,0,0,0,0,0,0.0
1473,23,Bashir Shah (DEN),2019-2019,4,4,0,0,0,0,0,0,0.0
1474,24,TC Bastiampillai (CAN),2010-2010,2,2,0,0,0,0,0,0,0.0
1475,25,MD Bates (NZ),2012-2012,3,3,0,0,0,0,0,0,0.0
1476,26,GJ Batty (ENG),2009-2009,1,1,0,0,0,0,0,0,0.0
1477,27,D Bau (PNG),2017-2017,1,1,0,0,0,0,0,0,0.0
1478,28,CS Baugh (WI),2008-2012,3,3,0,0,0,0,0,0,0.0
1479,29,DE Bernard (WI),2009-2009,1,1,0,0,0,0,0,0,0.0
1480,30,TL Best (WI),2013-2014,6,6,0,0,0,0,0,0,0.0
1481,31,P Bharat Patel (PNM),2019-2019,2,2,0,0,0,0,0,0,0.0
1482,32,S Bhari (NEPAL),2019-2019,6,6,0,0,0,0,0,0,0.0
1483,33,P Bhart (NOR),2019-2019,5,5,0,0,0,0,0,0,0.0
1484,34,A Bhattarai (NEPAL),2014-2014,1,1,0,0,0,0,0,0,0.0
1485,35,U Bhatti (CAN),2008-2010,7,7,0,0,0,0,0,0,0.0
1486,36,Bilal Ahmed (Serb),2019-2019,1,1,0,0,0,0,0,0,0.0
1487,37,IS Billcliff (CAN),2010-2010,2,2,0,0,0,0,0,0,0.0
1488,38,STR Binny (INDIA),2015-2016,3,3,0,0,0,0,0,0,0.0
1489,39,K Birkenstock (NAM),2019-2019,4,4,0,0,0,0,0,0,0.0
1490,40,KK Bishnoi (),2019-2019,3,3,0,0,0,0,0,0,0.0
1491,41,CC Blake (VAN),2019-2019,3,3,0,0,0,0,0,0,0.0
1492,42,AM Blignaut (ZIM),2010-2010,1,1,0,0,0,0,0,0,0.0
1493,43,GH Bodi (SA),2007-2007,1,1,0,0,0,0,0,0,0.0
1494,44,N Boje (SA),2005-2005,1,1,0,0,0,0,0,0,0.0
1495,45,NE Bonner (WI),2011-2012,2,2,0,0,0,0,0,0,0.0
1496,46,CJ Boyce (AUS),2014-2016,7,7,0,0,0,0,0,0,0.0
1497,47,TS Braat (NL),2019-2019,3,3,0,0,0,0,0,0,0.0
1498,48,DL Brangman (BMUDA),2019-2019,5,5,0,0,0,0,0,0,0.0
1499,49,DR Brown (SCOT),2007-2007,2,1,0,0,0,0,0,0,0.0
1500,0,P Buccimazza (PORT),2019-2019,4,4,0,0,0,0,0,0,0.0
1501,1,NB Budayair (NEPAL),2014-2014,4,4,0,0,0,0,0,0,0.0
1502,2,A Bulow (DEN),2019-2019,2,1,0,0,0,0,0,0,0.0
1503,3,CG Burnett (SCOT),2013-2013,1,1,0,0,0,0,0,0,0.0
1504,4,S Byrne (MALTA),2019-2019,2,2,0,0,0,0,0,0,0.0
1505,5,G Caisley (),2019-2019,4,4,0,0,0,0,0,0,0.0
1506,6,HL Carlyon (JER),2019-2019,9,9,0,0,0,0,0,0,0.0
1507,7,A Carthew (Chile),2019-2019,4,4,0,0,0,0,0,0,0.0
1508,8,T Caruana (GIBR),2019-2019,2,2,0,0,0,0,0,0,0.0
1509,9,D Cato (Caym),2019-2019,3,3,0,0,0,0,0,0,0.0
1510,10,JJ Celestine (BMUDA),2008-2008,3,3,0,0,0,0,0,0,0.0
1511,11,DL Chahar (INDIA),2018-2019,10,10,0,0,0,0,0,0,0.0
1512,12,RD Chahar (INDIA),2019-2019,1,1,0,0,0,0,0,0,0.0
1513,13,Charanjeet Singh (ITA),2019-2019,3,2,0,0,0,0,0,0,0.0
1514,14,G Chaturvedi (MALTA),2019-2019,2,2,0,0,0,0,0,0,0.0
1515,15,M Chauhan (Fin),2019-2019,2,2,0,0,0,0,0,0,0.0
1516,16,VB Chikkannaiah (GER),2019-2019,7,7,0,0,0,0,0,0,0.0
1517,17,Chirag Suri (UAE),2018-2019,7,7,0,0,0,0,0,0,0.0
1518,18,S Chophel (BHU),2019-2019,1,1,0,0,0,0,0,0,0.0
1519,19,DO Christian (WI),2011-2011,2,2,0,0,0,0,0,0,0.0
1520,20,I Civric (Serb),2019-2019,1,1,0,0,0,0,0,0,0.0
1521,21,GL Cloete (SA),2018-2019,2,2,0,0,0,0,0,0,0.0
1522,22,FRJ Coleman (SCOT),2013-2013,1,1,0,0,0,0,0,0,0.0
1523,23,NG Collins (Fin),2019-2019,5,5,0,0,0,0,0,0,0.0
1524,24,MNR Cooray (Mald),2019-2019,4,4,0,0,0,0,0,0,0.0
1525,25,M Cope (LUX),2019-2019,2,2,0,0,0,0,0,0,0.0
1526,26,SJ Cotter (Samoa),2019-2019,4,4,0,0,0,0,0,0,0.0
1527,27,MS Crane (ENG),2017-2017,2,2,0,0,0,0,0,0,0.0
1528,28,SM Curran (ENG),2019-2019,5,5,0,0,0,0,0,0,0.0
1529,29,D Daesrath (CAN),2013-2013,1,1,0,0,0,0,0,0,0.0
1530,30,H Dajc (Serb),2019-2019,2,2,0,0,0,0,0,0,0.0
1531,31,S Dalton (CZK-R),2019-2019,3,3,0,0,0,0,0,0,0.0
1532,32,I Danladi (NGA),2019-2019,3,3,0,0,0,0,0,0,0.0
1533,33,H Davids (SA),2012-2013,9,9,0,0,0,0,0,0,0.0
1534,34,S Davizi (CZK-R),2019-2019,2,2,0,0,0,0,0,0,0.0
1535,35,Dawlat Ahmadzai (AFG),2010-2010,2,2,0,0,0,0,0,0,0.0
1536,36,DC Delany (IRE),2019-2019,8,8,0,0,0,0,0,0,0.0
1537,37,D de la Puente (Peru),2019-2019,2,2,0,0,0,0,0,0,0.0
1538,38,PA Desai (CAN),2012-2012,1,1,0,0,0,0,0,0,0.0
1539,39,ST de Silva (SL),2017-2017,3,3,0,0,0,0,0,0,0.0
1540,40,BJ Diamanti (NZ),2009-2009,1,1,0,0,0,0,0,0,0.0
1541,41,V Dikov (),2019-2019,3,3,0,0,0,0,0,0,0.0
1542,42,LHD Dilhara (SL),2008-2008,2,2,0,0,0,0,0,0,0.0
1543,43,SDJJ Dima (Moz),2019-2019,4,3,0,0,0,0,0,0,0.0
1544,44,N Dipakkumar Patel (PNM),2019-2019,3,3,0,0,0,0,0,0,0.0
1545,45,HH Dippenaar (SA),2006-2006,1,1,0,0,0,0,0,0,0.0
1546,46,M Dixit (LUX),2019-2019,3,3,0,0,0,0,0,0,0.0
1547,47,A Djorovic (Serb),2019-2019,2,2,0,0,0,0,0,0,0.0
1548,48,XJ Doherty (AUS),2012-2013,11,11,0,0,0,0,0,0,0.0
1549,49,JN Dorji (BHU),2019-2019,1,1,0,0,0,0,0,0,0.0
1550,0,K Dorji (BHU),2019-2019,2,2,0,0,0,0,0,0,0.0
1551,1,RM Dorji (BHU),2019-2019,1,1,0,0,0,0,0,0,0.0
1552,2,U Dorji (BHU),2019-2019,2,2,0,0,0,0,0,0,0.0
1553,3,TM Dowlin (WI),2009-2010,2,2,0,0,0,0,0,0,0.0
1554,4,R Dravid (INDIA),2011-2011,1,1,0,0,0,0,0,0,0.0
1555,5,BM Duckett (ENG),2019-2019,1,1,0,0,0,0,0,0,0.0
1556,6,B Dugic (Serb),2019-2019,2,2,0,0,0,0,0,0,0.0
1557,7,J Dunn (VAN),2019-2019,4,4,0,0,0,0,0,0,0.0
1558,8,PS Eaglestone (IRE),2010-2010,1,1,0,0,0,0,0,0,0.0
1559,9,KR Ebanks (Caym),2019-2019,5,5,0,0,0,0,0,0,0.0
1560,10,Ehsan Nawaz (HKG),2014-2017,5,5,0,0,0,0,0,0,0.0
1561,11,AM Ellis (NZ),2012-2013,5,5,0,0,0,0,0,0,0.0
1562,12,C Emmott (Chile),2019-2019,2,2,0,0,0,0,0,0,0.0
1563,13,RR Emrit (WI),2018-2018,4,4,0,0,0,0,0,0,0.0
1564,14,Faizan Asif (UAE),2014-2015,6,6,0,0,0,0,0,0,0.0
1565,15,Fakhrul Mohon (PORT),2019-2019,4,4,0,0,0,0,0,0,0.0
1566,16,Fawad Ahmed (AUS),2013-2013,2,2,0,0,0,0,0,0,0.0
1567,17,Fazal Niazai (AFG),2019-2019,1,1,0,0,0,0,0,0,0.0
1568,18,H Fennell (Arg),2019-2019,5,5,0,0,0,0,0,0,0.0
1569,19,B Fernando (SL),2015-2015,2,2,0,0,0,0,0,0,0.0
1570,20,BOP Fernando (SL),2019-2019,3,3,0,0,0,0,0,0,0.0
1571,21,MVT Fernando (SL),2017-2017,1,1,0,0,0,0,0,0,0.0
1572,22,Fiaz Ahmad (KUW),2019-2019,3,3,0,0,0,0,0,0,0.0
1573,23,Fida Hussain (ITA),2019-2019,2,2,0,0,0,0,0,0,0.0
1574,24,R Flannigan (SCOT),2012-2012,4,4,0,0,0,0,0,0,0.0
1575,25,P Florin (ROM),2019-2019,4,4,0,0,0,0,0,0,0.0
1576,26,KK Flowers (Blz),2019-2019,3,3,0,0,0,0,0,0,0.0
1577,27,C Floyd (NL),2019-2019,2,2,0,0,0,0,0,0,0.0
1578,28,BC Fortuin (SA),2019-2019,2,2,0,0,0,0,0,0,0.0
1579,29,AR Gandhi (KENYA),2019-2019,3,3,0,0,0,0,0,0,0.0
1580,30,D Ganga (WI),2006-2006,1,1,0,0,0,0,0,0,0.0
1581,31,MD Garratt (GIBR),2019-2019,4,4,0,0,0,0,0,0,0.0
1582,32,Garret Banner (Blz),2019-2019,1,1,0,0,0,0,0,0,0.0
1583,33,SP Gauchan (NEPAL),2014-2015,9,9,0,0,0,0,0,0,0.0
1584,34,A Gavde (Caym),2019-2019,1,1,0,0,0,0,0,0,0.0
1585,35,R Gaznavi (SGP),2019-2019,2,2,0,0,0,0,0,0,0.0
1586,36,B Geeves (AUS),2009-2009,1,1,0,0,0,0,0,0,0.0
1587,37,L Gharasim (ROM),2019-2019,2,2,0,0,0,0,0,0,0.0
1588,38,JN Gillespie (AUS),2005-2005,1,1,0,0,0,0,0,0,0.0
1589,39,O Goker (TKY),2019-2019,1,1,0,0,0,0,0,0,0.0
1590,40,GF Gomes (Moz),2019-2019,7,6,0,0,0,0,0,0,0.0
1591,41,M Goonetilleke (MALTA),2019-2019,1,1,0,0,0,0,0,0,0.0
1592,42,D Gough (ENG),2005-2006,2,2,0,0,0,0,0,0,0.0
1593,43,S Goustis (),2019-2019,3,3,0,0,0,0,0,0,0.0
1594,44,L Gregory (ENG),2019-2019,5,5,0,0,0,0,0,0,0.0
1595,45,R Gunasekera (CAN),2012-2013,8,8,0,0,0,0,0,0,0.0
1596,46,HF Gurney (ENG),2014-2014,2,2,0,0,0,0,0,0,0.0
1597,47,AJ Hall (SA),2006-2006,2,2,0,0,0,0,0,0,0.0
1598,48,PSP Handscomb (AUS),2019-2019,2,2,0,0,0,0,0,0,0.0
1599,49,Hardev Singh (Chile),2019-2019,3,3,0,0,0,0,0,0,0.0
1600,0,Haroon Arshad (HKG),2019-2019,10,10,0,0,0,0,0,0,0.0
1601,1,Haroon Mughal (MALTA),2019-2019,4,4,0,0,0,0,0,0,0.0
1602,2,LHB Harrington-Myers (Caym),2019-2019,4,4,0,0,0,0,0,0,0.0
1603,3,RJ Harris (AUS),2010-2010,3,3,0,0,0,0,0,0,0.0
1604,4,SM Harwood (AUS),2007-2009,3,3,0,0,0,0,0,0,0.0
1605,5,Hasheem Shahzad (MALTA),2019-2019,2,2,0,0,0,0,0,0,0.0
1606,6,Hashmatullah Shahidi (AFG),2013-2013,1,1,0,0,0,0,0,0,0.0
1607,7,Hassan Rasheed (Mald),2019-2019,8,8,0,0,0,0,0,0,0.0
1608,8,RJ Hatchman (GIBR),2019-2019,1,1,0,0,0,0,0,0,0.0
1609,9,Hayatullah Niazi (NOR),2019-2019,4,4,0,0,0,0,0,0,0.0
1610,10,H Helva (TKY),2019-2019,4,4,0,0,0,0,0,0,0.0
1611,11,DL Hemp (BMUDA),2008-2008,2,2,0,0,0,0,0,0,0.0
1612,12,T Henderson (SA),2006-2006,1,1,0,0,0,0,0,0,0.0
1613,13,PD Hennessy (ESP),2019-2019,8,8,0,0,0,0,0,0,0.0
1614,14,HMRKB Herath (SL),2011-2016,17,17,0,0,0,0,0,0,0.0
1615,15,BW Hilfenhaus (AUS),2007-2012,7,7,0,0,0,0,0,0,0.0
1616,16,J Hill (PHI),2019-2019,4,4,0,0,0,0,0,0,0.0
1617,17,H Hiri (PNG),2016-2019,5,5,0,0,0,0,0,0,0.0
1618,18,J Hirschi (MALTA),2019-2019,4,4,0,0,0,0,0,0,0.0
1619,19,PA Hitchcock (NZ),2008-2008,1,1,0,0,0,0,0,0,0.0
1620,20,KC Hodsoll (BMUDA),2008-2008,1,1,0,0,0,0,0,0,0.0
1621,21,S Hongsi (THAI),2019-2019,3,3,0,0,0,0,0,0,0.0
1622,22,PJ Hughes (AUS),2014-2014,1,1,0,0,0,0,0,0,0.0
1623,23,EH Hutchinson (USA),2019-2019,2,2,0,0,0,0,0,0,0.0
1624,24,Ibrahim Khan (Saudi),2019-2019,1,1,0,0,0,0,0,0,0.0
1625,25,Iftikhar Anjum (PAK),2007-2009,2,2,0,0,0,0,0,0,0.0
1626,26,Ijaz Hussain (ROM),2019-2019,3,3,0,0,0,0,0,0,0.0
1627,27,Imam-ul-Haq (PAK),2019-2019,2,2,0,0,0,0,0,0,0.0
1628,28,Imran Ali Butt (BAH),2019-2019,4,4,0,0,0,0,0,0,0.0
1629,29,Imran Bulbulia (PNM),2019-2019,3,3,0,0,0,0,0,0,0.0
1630,30,Imran Khan (PORT),2019-2019,4,4,0,0,0,0,0,0,0.0
1631,31,RK Inampud (Mex),2019-2019,3,3,0,0,0,0,0,0,0.0
1632,32,Inzamam-ul-Haq (PAK),2006-2006,1,1,0,0,0,0,0,0,0.0
1633,33,AJ Ireland (ZIM),2006-2006,1,1,0,0,0,0,0,0,0.0
1634,34,Irfan Bhima (MWI),2019-2019,4,4,0,0,0,0,0,0,0.0
1635,35,Irfan Mir (Chile),2019-2019,4,4,0,0,0,0,0,0,0.0
1636,36,E Isaneez (UGA),2019-2019,3,3,0,0,0,0,0,0,0.0
1637,37,B Ivanov (),2019-2019,3,3,0,0,0,0,0,0,0.0
1638,38,D Jakiel (ZIM),2019-2019,2,2,0,0,0,0,0,0,0.0
1639,39,NA Janes (THAI),2019-2019,2,2,0,0,0,0,0,0,0.0
1640,40,T Jamtsho (BHU),2019-2019,2,2,0,0,0,0,0,0,0.0
1641,41,Javed Ahmadi (AFG),2012-2017,3,3,0,0,0,0,0,0,0.0
1642,42,Javed Maroofkhail (NOR),2019-2019,2,2,0,0,0,0,0,0,0.0
1643,43,CU Jayasinghe (SL),2009-2010,5,5,0,0,0,0,0,0,0.0
1644,44,P Jayeshbhai Patel (PNM),2019-2019,2,2,0,0,0,0,0,0,0.0
1645,45,Jay Odedra (OMAN),2019-2019,3,3,0,0,0,0,0,0,0.0
1646,46,JS Jesani (KENYA),2007-2007,1,1,0,0,0,0,0,0,0.0
1647,47,HJ Jordaan (THAI),2019-2019,4,4,0,0,0,0,0,0,0.0
1648,48,GJ Joseph (Blz),2019-2019,1,1,0,0,0,0,0,0,0.0
1649,49,K Joshi (Aut),2019-2019,4,4,0,0,0,0,0,0,0.0
1650,0,Jubair Hossain (BDESH),2015-2015,1,1,0,0,0,0,0,0,0.0
1651,1,Junaid Khan (PAK),2011-2014,9,9,0,0,0,0,0,0,0.0
1652,2,S Jyoti (CAN),2008-2008,2,2,0,0,0,0,0,0,0.0
1653,3,Kaleemullah (OMAN),2017-2019,6,6,0,0,0,0,0,0,0.0
1654,4,G Kaltongga (VAN),2019-2019,3,3,0,0,0,0,0,0,0.0
1655,5,S Randiv (SL),2010-2011,7,7,0,0,0,0,0,0,0.0
1656,6,TP Kamungozi (ZIM),2014-2014,1,1,0,0,0,0,0,0,0.0
1657,7,S Kansoy (TKY),2019-2019,4,4,0,0,0,0,0,0,0.0
1658,8,A Karn (NEPAL),2015-2015,2,2,0,0,0,0,0,0,0.0
1659,9,M Kartik (INDIA),2007-2007,1,1,0,0,0,0,0,0,0.0
1660,10,E Katchay (CAN),2008-2008,4,4,0,0,0,0,0,0,0.0
1661,11,S Kaul (INDIA),2018-2019,3,3,0,0,0,0,0,0,0.0
1662,12,HB Kayondo (UGA),2019-2019,3,3,0,0,0,0,0,0,0.0
1663,13,D Kegasitswe (Botsw),2019-2019,4,4,0,0,0,0,0,0,0.0
1664,14,SKW Kelly (BMUDA),2008-2008,3,3,0,0,0,0,0,0,0.0
1665,15,P Kerai (KENYA),2019-2019,6,6,0,0,0,0,0,0,0.0
1666,16,A Khan (ENG),2009-2009,1,1,0,0,0,0,0,0,0.0
1667,17,B Khumalo (Botsw),2019-2019,3,3,0,0,0,0,0,0,0.0
1668,18,Khurram Manzoor (PAK),2016-2016,3,3,0,0,0,0,0,0,0.0
1669,19,Khushdil Shah (PAK),2019-2019,1,1,0,0,0,0,0,0,0.0
1670,20,JH Kiani (PHI),2019-2019,4,4,0,0,0,0,0,0,0.0
1671,21,GE Kidd (IRE),2010-2010,1,1,0,0,0,0,0,0,0.0
1672,22,VJ Kingma (NL),2016-2019,4,4,0,0,0,0,0,0,0.0
1673,23,RJ Kirtley (ENG),2007-2007,1,1,0,0,0,0,0,0,0.0
1674,24,S Kizilkaya (TKY),2019-2019,4,4,0,0,0,0,0,0,0.0
1675,25,MF Koc (TKY),2019-2019,2,2,0,0,0,0,0,0,0.0
1676,26,AC Kose (TKY),2019-2019,4,4,0,0,0,0,0,0,0.0
1677,27,A Krishna (SGP),2019-2019,4,4,0,0,0,0,0,0,0.0
1678,28,GJP Kruger (SA),2006-2006,1,1,0,0,0,0,0,0,0.0
1679,29,DS Kulkarni (INDIA),2016-2016,2,2,0,0,0,0,0,0,0.0
1680,30,CBRLS Kumara (SL),2019-2019,3,3,0,0,0,0,0,0,0.0
1681,31,Kushal Malla (NEPAL),2019-2019,3,3,0,0,0,0,0,0,0.0
1682,32,GA Lamb (ZIM),2010-2010,5,5,0,0,0,0,0,0,0.0
1683,33,T Langa (VAN),2019-2019,1,1,0,0,0,0,0,0,0.0
1684,34,E Leie (SA),2015-2015,2,2,0,0,0,0,0,0,0.0
1685,35,RDM Leverock (BMUDA),2008-2008,2,2,0,0,0,0,0,0,0.0
1686,36,I Lisboa (Chile),2019-2019,1,1,0,0,0,0,0,0,0.0
1687,37,LS Livingstone (ENG),2017-2017,2,2,0,0,0,0,0,0,0.0
1688,38,CA Liyanage (Mald),2019-2019,2,2,0,0,0,0,0,0,0.0
1689,39,K Loday (BHU),2019-2019,1,1,0,0,0,0,0,0,0.0
1690,40,J Louw (SA),2008-2009,2,2,0,0,0,0,0,0,0.0
1691,41,L Louwrens (NAM),2019-2019,1,1,0,0,0,0,0,0,0.0
1692,42,Lucky Ali (DEN),2019-2019,2,2,0,0,0,0,0,0,0.0
1693,43,NM Lyon (AUS),2016-2018,2,2,0,0,0,0,0,0,0.0
1694,44,RT Lyons (SCOT),2010-2010,2,2,0,0,0,0,0,0,0.0
1695,45,AM McCarthy (WI),2018-2018,1,1,0,0,0,0,0,0,0.0
1696,46,NFI McCallum (SCOT),2007-2010,11,10,0,0,0,0,0,0,0.0
1697,47,OC McCoy (WI),2019-2019,2,2,0,0,0,0,0,0,0.0
1698,48,AJ McKay (NZ),2010-2010,2,2,0,0,0,0,0,0,0.0
1699,49,CJ McKay (AUS),2010-2013,6,6,0,0,0,0,0,0,0.0
1700,0,ND McKenzie (SA),2006-2009,2,2,0,0,0,0,0,0,0.0
1701,1,DSK Madushanka (SL),2018-2018,2,2,0,0,0,0,0,0,0.0
1702,2,LD Madushanka (SL),2019-2019,2,2,0,0,0,0,0,0,0.0
1703,3,RP Magar (NEPAL),2014-2015,6,6,0,0,0,0,0,0,0.0
1704,4,R Mahajan (PHI),2019-2019,3,3,0,0,0,0,0,0,0.0
1705,5,C Mahoney (Peru),2019-2019,3,3,0,0,0,0,0,0,0.0
1706,6,Mamoon Latif (Belg),2019-2019,3,3,0,0,0,0,0,0,0.0
1707,7,G Manan (ROM),2019-2019,3,3,0,0,0,0,0,0,0.0
1708,8,D Manani (ROM),2019-2019,2,2,0,0,0,0,0,0,0.0
1709,9,M Markande (INDIA),2019-2019,1,1,0,0,0,0,0,0,0.0
1710,10,D Marks (MALTA),2019-2019,2,2,0,0,0,0,0,0,0.0
1711,11,JAH Marshall (NZ),2005-2008,3,3,0,0,0,0,0,0,0.0
1712,12,JL Martel (GUE),2019-2019,3,3,0,0,0,0,0,0,0.0
1713,13,B Masaba (UGA),2019-2019,1,1,0,0,0,0,0,0,0.0
1714,14,MJ Mason (NZ),2006-2008,3,3,0,0,0,0,0,0,0.0
1715,15,N Master (Botsw),2019-2019,2,2,0,0,0,0,0,0,0.0
1716,16,ZE Matsinhe (Moz),2019-2019,7,6,0,0,0,0,0,0,0.0
1717,17,V Mbazo (Botsw),2019-2019,4,4,0,0,0,0,0,0,0.0
1718,18,GJ McCarter (IRE),2015-2015,3,2,0,0,0,0,0,0,0.0
1719,19,BJ McCarthy (IRE),2017-2018,6,6,0,0,0,0,0,0,0.0
1720,20,Z McLaughlin (Caym),2019-2019,3,3,0,0,0,0,0,0,0.0
1721,21,A Mehmood (HKG),2016-2016,2,2,0,0,0,0,0,0,0.0
1722,22,Mehrab Hossain jnr (BDESH),2008-2009,2,2,0,0,0,0,0,0,0.0
1723,23,D Mejia (CRC),2019-2019,3,3,0,0,0,0,0,0,0.0
1724,24,K Mendon (CZK-R),2019-2019,6,6,0,0,0,0,0,0,0.0
1725,25,JH Mensah (Ghana),2019-2019,2,2,0,0,0,0,0,0,0.0
1726,26,DP Michael (Samoa),2019-2019,4,4,0,0,0,0,0,0,0.0
1727,27,Michael Nazir (MALTA),2019-2019,1,1,0,0,0,0,0,0,0.0
1728,28,Mihusan Hamid (Mald),2019-2019,1,1,0,0,0,0,0,0,0.0
1729,29,Mirza Ahsan (Aut),2019-2019,5,5,0,0,0,0,0,0,0.0
1730,30,Mohamed Arief (MAL),2019-2019,5,5,0,0,0,0,0,0,0.0
1731,31,Mohameed Taiwo (NGA),2019-2019,2,2,0,0,0,0,0,0,0.0
1732,32,Mohammad Adnan (Saudi),2019-2019,5,5,0,0,0,0,0,0,0.0
1733,33,Mohammad Ahsan (KUW),2019-2019,6,6,0,0,0,0,0,0,0.0
1734,34,Mohammad Amin (KUW),2019-2019,4,4,0,0,0,0,0,0,0.0
1735,35,Mohammad Hasnain (PAK),2019-2019,4,4,0,0,0,0,0,0,0.0
1736,36,Mohammad Iqbal (CAN),2008-2008,3,3,0,0,0,0,0,0,0.0
1737,37,Mohamed Mahfooz (Mald),2019-2019,11,11,0,0,0,0,0,0,0.0
1738,38,Mohammad Qazi (CAN),2008-2008,1,1,0,0,0,0,0,0,0.0
1739,39,Mohammad Rafique (BDESH),2006-2006,1,1,0,0,0,0,0,0,0.0
1740,40,Mohammad Shahid (BDESH),2016-2016,1,1,0,0,0,0,0,0,0.0
1741,41,Mohammed Shami (INDIA),2014-2019,8,8,0,0,0,0,0,0,0.0
1742,42,MR Montfort (CAN),2019-2019,1,1,0,0,0,0,0,0,0.0
1743,43,VV Morea (PNG),2015-2017,5,5,0,0,0,0,0,0,0.0
1744,44,A Morris (Caym),2019-2019,6,6,0,0,0,0,0,0,0.0
1745,45,JWN Moses (Botsw),2019-2019,3,3,0,0,0,0,0,0,0.0
1746,46,Mohsin Hub (Peru),2019-2019,4,4,0,0,0,0,0,0,0.0
1747,47,Muaviath Ganee (Mald),2019-2019,5,5,0,0,0,0,0,0,0.0
1748,48,Muhammad Hamayun (Saudi),2019-2019,4,4,0,0,0,0,0,0,0.0
1749,49,Muhammad Musa (PAK),2019-2019,1,1,0,0,0,0,0,0,0.0
1750,0,Muhammad Rafique (BAH),2019-2019,2,2,0,0,0,0,0,0,0.0
1751,1,Muhammed Shanil (UAE),2016-2016,1,1,0,0,0,0,0,0,0.0
1752,2,Muhammad Wafiq (MAL),2019-2019,4,4,0,0,0,0,0,0,0.0
1753,3,D Muhumuza (UGA),2019-2019,4,4,0,0,0,0,0,0,0.0
1754,4,Mukhtiar Singh (ESP),2019-2019,2,2,0,0,0,0,0,0,0.0
1755,5,Muktar Ali (BDESH),2016-2016,1,1,0,0,0,0,0,0,0.0
1756,6,FF Mulivai (Samoa),2019-2019,4,4,0,0,0,0,0,0,0.0
1757,7,T Mupariwa (ZIM),2007-2008,4,4,0,0,0,0,0,0,0.0
1758,8,S Murari (CRC),2019-2019,3,3,0,0,0,0,0,0,0.0
1759,9,Musa Shaheen (DEN),2019-2019,1,1,0,0,0,0,0,0,0.0
1760,10,P Mustard (ENG),2008-2008,2,2,0,0,0,0,0,0,0.0
1761,11,F Mutizwa (ZIM),2011-2012,3,3,0,0,0,0,0,0,0.0
1762,12,Nadif Chowdhury (BDESH),2006-2007,3,3,0,0,0,0,0,0,0.0
1763,13,S Nadigotla (ROM),2019-2019,2,2,0,0,0,0,0,0,0.0
1764,14,Najeeb Amar (HKG),2014-2014,1,1,0,0,0,0,0,0,0.0
1765,15,A Nanda (LUX),2019-2019,3,3,0,0,0,0,0,0,0.0
1766,16,M Nandela (Mex),2019-2019,2,2,0,0,0,0,0,0,0.0
1767,17,A Nao (PNG),2017-2017,2,2,0,0,0,0,0,0,0.0
1768,18,Nasir Aziz (UAE),2015-2015,1,1,0,0,0,0,0,0,0.0
1769,19,Nasrulla Rana (HKG),2019-2019,8,8,0,0,0,0,0,0,0.0
1770,20,Nauman Anwar (PAK),2015-2015,1,1,0,0,0,0,0,0,0.0
1771,21,NH Naureen (ESP),2019-2019,1,1,0,0,0,0,0,0,0.0
1772,22,Naveen-ul-Haq (AFG),2019-2019,4,4,0,0,0,0,0,0,0.0
1773,23,Nawaf Ahmed (KUW),2019-2019,1,1,0,0,0,0,0,0,0.0
1774,24,Nazimuddin (BDESH),2007-2008,7,7,0,0,0,0,0,0,0.0
1775,25,Nazmul Hossain (BDESH),2009-2012,4,4,0,0,0,0,0,0,0.0
1776,26,Nazmus Sadat (BDESH),2006-2006,1,1,0,0,0,0,0,0,0.0
1777,27,R Neale (LUX),2019-2019,3,3,0,0,0,0,0,0,0.0
1778,28,S Nerandzic (Serb),2019-2019,2,2,0,0,0,0,0,0,0.0
1779,29,R Ngarava (ZIM),2019-2019,1,1,0,0,0,0,0,0,0.0
1780,30,JO Ngoche (KENYA),2012-2013,7,7,0,0,0,0,0,0,0.0
1781,31,HM Nicholls (NZ),2016-2019,5,5,0,0,0,0,0,0,0.0
1782,32,D Nikolov (),2019-2019,3,3,0,0,0,0,0,0,0.0
1783,33,K Nima (BHU),2019-2019,1,1,0,0,0,0,0,0,0.0
1784,34,ML Nkala (ZIM),2006-2006,1,1,0,0,0,0,0,0,0.0
1785,35,F Nkhoma (MWI),2019-2019,4,4,0,0,0,0,0,0,0.0
1786,36,AA Noffke (AUS),2007-2008,2,2,0,0,0,0,0,0,0.0
1787,37,Noman Kamawi (Belg),2019-2019,1,1,0,0,0,0,0,0,0.0
1788,38,MJ North (AUS),2009-2009,1,1,0,0,0,0,0,0,0.0
1789,39,A Nortje (SA),2019-2019,1,1,0,0,0,0,0,0,0.0
1790,40,L Nou (PNG),2015-2015,3,3,0,0,0,0,0,0,0.0
1791,41,GM Ntambalika (MWI),2019-2019,3,3,0,0,0,0,0,0,0.0
1792,42,J Nyumbu (ZIM),2018-2018,2,2,0,0,0,0,0,0,0.0
1793,43,IE O'Brien (NZ),2009-2009,4,4,0,0,0,0,0,0,0.0
1794,44,NV Ojha (INDIA),2010-2010,2,2,0,0,0,0,0,0,0.0
1795,45,PJ Ongondo (KENYA),2007-2008,8,8,0,0,0,0,0,0,0.0
1796,46,LN Onyango (KENYA),2007-2010,5,5,0,0,0,0,0,0,0.0
1797,47,A Orfila (GIBR),2019-2019,1,1,0,0,0,0,0,0,0.0
1798,48,Ovais Yousof (NGA),2019-2019,3,3,0,0,0,0,0,0,0.0
1799,49,VS Padhaal (Fin),2019-2019,5,5,0,0,0,0,0,0,0.0
1800,0,BA Pai (GIBR),2019-2019,4,4,0,0,0,0,0,0,0.0
1801,1,RJG Palmer (JER),2019-2019,2,2,0,0,0,0,0,0,0.0
1802,2,MS Panesar (ENG),2007-2007,1,1,0,0,0,0,0,0,0.0
1803,3,BA Parchment (WI),2007-2007,1,1,0,0,0,0,0,0,0.0
1804,4,MA Parker (SCOT),2012-2012,2,2,0,0,0,0,0,0,0.0
1805,5,MW Parkinson (ENG),2019-2019,2,2,0,0,0,0,0,0,0.0
1806,6,Parvez Rasool (INDIA),2017-2017,1,1,0,0,0,0,0,0,0.0
1807,7,A Patel (MWI),2019-2019,2,2,0,0,0,0,0,0,0.0
1808,8,AY Patel (NZ),2018-2018,2,2,0,0,0,0,0,0,0.0
1809,9,M Patel (PNM),2019-2019,2,2,0,0,0,0,0,0,0.0
1810,10,M Patel (Chile),2019-2019,3,3,0,0,0,0,0,0,0.0
1811,11,MIA Patel (MWI),2019-2019,3,3,0,0,0,0,0,0,0.0
1812,12,MM Patel (INDIA),2011-2011,3,3,0,0,0,0,0,0,0.0
1813,13,TK Patel (USA),2019-2019,7,7,0,0,0,0,0,0,0.0
1814,14,N Pathan (THAI),2019-2019,4,4,0,0,0,0,0,0,0.0
1815,15,SS Pathirana (SL),2016-2017,5,5,0,0,0,0,0,0,0.0
1816,16,WA Peatfield (GUE),2019-2019,8,8,0,0,0,0,0,0,0.0
1817,17,MDK Perera (SL),2011-2011,3,3,0,0,0,0,0,0,0.0
1818,18,PDRL Perera (SL),2006-2006,2,2,0,0,0,0,0,0,0.0
1819,19,S Periyalwar (ROM),2019-2019,4,4,0,0,0,0,0,0,0.0
1820,20,V Permaul (WI),2018-2018,1,1,0,0,0,0,0,0,0.0
1821,21,AM Phangiso (SA),2012-2018,16,16,0,0,0,0,0,0,0.0
1822,22,T Phaswana (Botsw),2019-2019,1,1,0,0,0,0,0,0,0.0
1823,23,S Pillai (CRC),2019-2019,3,3,0,0,0,0,0,0,0.0
1824,24,LA Pomersbach (AUS),2007-2007,1,1,0,0,0,0,0,0,0.0
1825,25,VRCF Poubel (),2019-2019,3,3,0,0,0,0,0,0,0.0
1826,26,H Pragji (Botsw),2019-2019,4,4,0,0,0,0,0,0,0.0
1827,27,C Prasad (CRC),2019-2019,3,3,0,0,0,0,0,0,0.0
1828,28,KTGD Prasad (SL),2011-2011,1,1,0,0,0,0,0,0,0.0
1829,29,D Pretorius (SA),2017-2019,6,6,0,0,0,0,0,0,0.0
1830,30,AG Prince (SA),2005-2005,1,1,0,0,0,0,0,0,0.0
1831,31,SMA Priyanjan (SL),2017-2017,3,3,0,0,0,0,0,0,0.0
1832,32,Qalandar Khan (QAT),2019-2019,4,4,0,0,0,0,0,0,0.0
1833,33,Qasim Zia (BAH),2019-2019,3,3,0,0,0,0,0,0,0.0
1834,34,Rafatullah Mohmand (PAK),2015-2015,3,3,0,0,0,0,0,0,0.0
1835,35,Rahman Ademi (Serb),2019-2019,2,2,0,0,0,0,0,0,0.0
1836,36,P Raho (PNG),2016-2016,2,2,0,0,0,0,0,0,0.0
1837,37,EC Rainsford (ZIM),2010-2010,2,2,0,0,0,0,0,0,0.0
1838,38,PBB Rajapaksa (SL),2019-2019,5,5,0,0,0,0,0,0,0.0
1839,39,Raja Adeel (ESP),2019-2019,3,3,0,0,0,0,0,0,0.0
1840,40,CAK Rajitha (SL),2016-2019,10,10,0,0,0,0,0,0,0.0
1841,41,Rakibul Hasan (ITA),2019-2019,8,7,0,0,0,0,0,0,0.0
1842,42,RLB Rambukwella (SL),2013-2016,2,2,0,0,0,0,0,0,0.0
1843,43,Rameez Raja (2) (PAK),2011-2011,2,2,0,0,0,0,0,0,0.0
1844,44,SHA Rance (NZ),2017-2019,8,7,0,0,0,0,0,0,0.0
1845,45,DA Rankin (IRE),2015-2016,2,2,0,0,0,0,0,0,0.0
1846,46,RJ Ranpura (OMAN),2015-2016,3,2,0,0,0,0,0,0,0.0
1847,47,Rashid Khan (NEPAL),2019-2019,1,1,0,0,0,0,0,0,0.0
1848,48,KB Ratilal (PNM),2019-2019,3,3,0,0,0,0,0,0,0.0
1849,49,Ravinder Singh (MALTA),2019-2019,2,2,0,0,0,0,0,0,0.0
1850,0,Razmal Shigiwal (Aut),2019-2019,4,4,0,0,0,0,0,0,0.0
1851,1,NJ Reardon (AUS),2014-2014,2,2,0,0,0,0,0,0,0.0
1852,2,J Reb (Serb),2019-2019,2,2,0,0,0,0,0,0,0.0
1853,3,Riazat Ali Shah (UGA),2019-2019,4,4,0,0,0,0,0,0,0.0
1854,4,ACL Richards (WI),2007-2007,1,1,0,0,0,0,0,0,0.0
1855,5,DM Richards (WI),2009-2009,1,1,0,0,0,0,0,0,0.0
1856,6,EB Ringera (KENYA),2019-2019,1,1,0,0,0,0,0,0,0.0
1857,7,R Rivas (Chile),2019-2019,3,3,0,0,0,0,0,0,0.0
1858,8,CP Rizwan (UAE),2019-2019,5,5,0,0,0,0,0,0,0.0
1859,9,Rizwan Mahmood (DEN),2019-2019,5,3,0,0,0,0,0,0,0.0
1860,10,WJR Robertson (JER),2019-2019,6,6,0,0,0,0,0,0,0.0
1861,11,Robiul Islam (BDESH),2013-2013,1,1,0,0,0,0,0,0,0.0
1862,12,GA Rogers (SCOT),2008-2009,2,2,0,0,0,0,0,0,0.0
1863,13,BJ Rohrer (AUS),2013-2013,1,1,0,0,0,0,0,0,0.0
1864,14,Rokhan Barakzai (AFG),2015-2015,3,3,0,0,0,0,0,0,0.0
1865,15,Rony Talukdar (BDESH),2015-2015,1,1,0,0,0,0,0,0,0.0
1866,16,JA Rudolph (SA),2006-2006,1,1,0,0,0,0,0,0,0.0
1867,17,SI Runsewe (NGA),2019-2019,6,6,0,0,0,0,0,0,0.0
1868,18,AK Sah (NEPAL),2018-2018,1,1,0,0,0,0,0,0,0.0
1869,19,TK Saha (Fin),2019-2019,4,4,0,0,0,0,0,0,0.0
1870,20,Sajid Liaqat (GER),2019-2019,2,2,0,0,0,0,0,0,0.0
1871,21,Sakib Hasan (Serb),2019-2019,2,2,0,0,0,0,0,0,0.0
1872,22,BA Sambo (Moz),2019-2019,2,2,0,0,0,0,0,0,0.0
1873,23,O Sam Arthur (CRC),2019-2019,3,3,0,0,0,0,0,0,0.0
1874,24,Sandeep Sharma (INDIA),2015-2015,2,2,0,0,0,0,0,0,0.0
1875,25,Saqlain Ali (Belg),2019-2019,2,2,0,0,0,0,0,0,0.0
1876,26,Saqlain Sajib (BDESH),2016-2016,1,1,0,0,0,0,0,0,0.0
1877,27,Sarfaraz Ali (BAH),2019-2019,4,4,0,0,0,0,0,0,0.0
1878,28,R Satheesan (ROM),2019-2019,4,4,0,0,0,0,0,0,0.0
1879,29,JOP Scamans (Fin),2019-2019,2,2,0,0,0,0,0,0,0.0
1880,30,K Senamontree (THAI),2019-2019,2,2,0,0,0,0,0,0,0.0
1881,31,YSD Seneveratne (Caym),2019-2019,6,6,0,0,0,0,0,0,0.0
1882,32,M Sert (TKY),2019-2019,4,4,0,0,0,0,0,0,0.0
1883,33,Shabbir Ahmed (PAK),2007-2007,1,1,0,0,0,0,0,0,0.0
1884,34,Shabir Noori (AFG),2012-2012,1,1,0,0,0,0,0,0,0.0
1885,35,L Shafeeg (Mald),2019-2019,3,3,0,0,0,0,0,0,0.0
1886,36,Shahadat Hossain (BDESH),2006-2013,6,6,0,0,0,0,0,0,0.0
1887,37,Shahbaz Badar (BAH),2019-2019,3,3,0,0,0,0,0,0,0.0
1888,38,Shahzad Muhammad (Mex),2019-2019,2,2,0,0,0,0,0,0,0.0
1889,39,Sharif Asadullah (UAE),2014-2014,1,1,0,0,0,0,0,0,0.0
1890,40,KV Sharma (INDIA),2014-2014,1,1,0,0,0,0,0,0,0.0
1891,41,R Sharma (INDIA),2012-2012,2,2,0,0,0,0,0,0,0.0
1892,42,ZK Shem (VAN),2019-2019,5,5,0,0,0,0,0,0,0.0
1893,43,Shoaib Gazi Hossain (Chile),2019-2019,4,4,0,0,0,0,0,0,0.0
1894,44,PM Siddle (AUS),2009-2010,2,2,0,0,0,0,0,0,0.0
1895,45,KM Silva (),2019-2019,3,3,0,0,0,0,0,0,0.0
1896,46,BA Simango (Moz),2019-2019,2,2,0,0,0,0,0,0,0.0
1897,47,LA Simango (Moz),2019-2019,3,3,0,0,0,0,0,0,0.0
1898,48,M Simmons (BMUDA),2019-2019,2,2,0,0,0,0,0,0,0.0
1899,49,Simranjit Singh (ITA),2019-2019,1,1,0,0,0,0,0,0,0.0
1900,0,MS Sinclair (NZ),2005-2007,2,2,0,0,0,0,0,0,0.0
1901,1,H Singh (GER),2019-2019,7,7,0,0,0,0,0,0,0.0
1902,2,S Singh (PHI),2019-2019,4,4,0,0,0,0,0,0,0.0
1903,3,S Singh (PORT),2019-2019,1,1,0,0,0,0,0,0,0.0
1904,4,JR Singleton (),2019-2019,3,3,0,0,0,0,0,0,0.0
1905,5,T Singye (BHU),2019-2019,2,2,0,0,0,0,0,0,0.0
1906,6,RM Siri (Arg),2019-2019,4,4,0,0,0,0,0,0,0.0
1907,7,DC Smith (PHI),2019-2019,4,4,0,0,0,0,0,0,0.0
1908,8,OF Smith (WI),2018-2018,2,2,0,0,0,0,0,0,0.0
1909,9,RAJ Smith (SCOT),2019-2019,2,2,0,0,0,0,0,0,0.0
1910,10,Sohail Khan (PAK),2008-2017,5,5,0,0,0,0,0,0,0.0
1911,11,S Sohal (USA),2019-2019,3,3,0,0,0,0,0,0,0.0
1912,12,Soheel Hussain (Belg),2019-2019,1,1,0,0,0,0,0,0,0.0
1913,13,M Sohel Patel (PNM),2019-2019,2,2,0,0,0,0,0,0,0.0
1914,14,Sohrawordi Shuvo (BDESH),2010-2010,1,1,0,0,0,0,0,0,0.0
1915,15,S Sola (Samoa),2019-2019,4,4,0,0,0,0,0,0,0.0
1916,16,S Soosiyakumar (),2019-2019,1,1,0,0,0,0,0,0,0.0
1917,17,ES Soto (CRC),2019-2019,1,1,0,0,0,0,0,0,0.0
1918,18,M Spry (Peru),2019-2019,4,4,0,0,0,0,0,0,0.0
1919,19,BB Sran (INDIA),2016-2016,2,2,0,0,0,0,0,0,0.0
1920,20,L Sreekumar (UAE),2017-2017,1,1,0,0,0,0,0,0,0.0
1921,21,H Ssenyondo (UGA),2019-2019,4,4,0,0,0,0,0,0,0.0
1922,22,AJ Staal (NL),2019-2019,9,9,0,0,0,0,0,0,0.0
1923,23,B Stanlake (AUS),2017-2019,19,19,0,0,0,0,0,0,0.0
1924,24,AL Stephen (VAN),2019-2019,2,2,0,0,0,0,0,0,0.0
1925,25,BS Stephenson (Blz),2019-2019,3,3,0,0,0,0,0,0,0.0
1926,26,TJ Stephenson (Blz),2019-2019,1,1,0,0,0,0,0,0,0.0
1927,27,Suhail Sadiq (LUX),2019-2019,2,2,0,0,0,0,0,0,0.0
1928,28,Suhrid Roy (MALTA),2019-2019,1,1,0,0,0,0,0,0,0.0
1929,29,Sumair Khan (MALTA),2019-2019,1,1,0,0,0,0,0,0,0.0
1930,30,Suresh Kumar (Peru),2019-2019,2,2,0,0,0,0,0,0,0.0
1931,31,ZE Surkari (CAN),2008-2008,4,4,0,0,0,0,0,0,0.0
1932,32,MJ Swepson (AUS),2018-2018,1,1,0,0,0,0,0,0,0.0
1933,33,Syazrul Idrus (MAL),2019-2019,2,2,0,0,0,0,0,0,0.0
1934,34,Tafseer Ali (NOR),2019-2019,5,5,0,0,0,0,0,0,0.0
1935,35,Taijul Islam (BDESH),2019-2019,2,2,0,0,0,0,0,0,0.0
1936,36,Talha Khan (GER),2019-2019,1,1,0,0,0,0,0,0,0.0
1937,37,Tanvir Ahmed (PAK),2010-2010,1,1,0,0,0,0,0,0,0.0
1938,38,Tariq Aziz (PORT),2019-2019,4,4,0,0,0,0,0,0,0.0
1939,39,Tarun Sharma (Mex),2019-2019,8,8,0,0,0,0,0,0,0.0
1940,40,R Telemachus (SA),2006-2007,3,3,0,0,0,0,0,0,0.0
1941,41,VE Tembo (Moz),2019-2019,6,5,0,0,0,0,0,0,0.0
1942,42,H Thaker (CAN),2019-2019,1,1,0,0,0,0,0,0,0.0
1943,43,J Thinley (BHU),2019-2019,2,2,0,0,0,0,0,0,0.0
1944,44,AC Thomas (SA),2007-2007,1,1,0,0,0,0,0,0,0.0
1945,45,O Thomas (WI),2018-2019,10,10,0,0,0,0,0,0,0.0
1946,46,EP Thompson (NZ),2008-2008,1,1,0,0,0,0,0,0,0.0
1947,47,S Thuraisingam (CAN),2008-2008,3,3,0,0,0,0,0,0,0.0
1948,48,SF Tiai (Samoa),2019-2019,4,4,0,0,0,0,0,0,0.0
1949,49,BM Tickner (NZ),2019-2019,3,3,0,0,0,0,0,0,0.0
1950,0,CT Tremlett (ENG),2007-2007,1,1,0,0,0,0,0,0,0.0
1951,1,IJL Trott (ENG),2007-2010,7,7,0,0,0,0,0,0,0.0
1952,2,RJ Trott (BMUDA),2008-2019,15,15,0,0,0,0,0,0,0.0
1953,3,TE Tucker (BMUDA),2008-2008,1,1,0,0,0,0,0,0,0.0
1954,4,DR Tuffey (NZ),2005-2010,3,3,0,0,0,0,0,0,0.0
1955,5,T Turan (TKY),2019-2019,4,4,0,0,0,0,0,0,0.0
1956,6,HER Tyler (PHI),2019-2019,2,2,0,0,0,0,0,0,0.0
1957,7,ML Udawatte (SL),2008-2017,8,8,0,0,0,0,0,0,0.0
1958,8,T Ulutuna (TKY),2019-2019,3,3,0,0,0,0,0,0,0.0
1959,9,R Ulutuna (TKY),2019-2019,4,4,0,0,0,0,0,0,0.0
1960,10,Umair Ali (UAE),2015-2015,3,3,0,0,0,0,0,0,0.0
1961,11,J Umanath (Mex),2019-2019,7,7,0,0,0,0,0,0,0.0
1962,12,Usman Mushtaq (UAE),2016-2016,3,3,0,0,0,0,0,0,0.0
1963,13,WPUJC Vaas (SL),2006-2007,6,6,0,0,0,0,0,0,0.0
1964,14,JJ van der Wath (SA),2006-2007,8,8,0,0,0,0,0,0,0.0
1965,15,VB van Jaarsveld (SA),2009-2009,3,3,0,0,0,0,0,0,0.0
1966,16,S Varathappan (KUW),2019-2019,3,3,0,0,0,0,0,0,0.0
1967,17,MP Vaughan (ENG),2005-2007,2,2,0,0,0,0,0,0,0.0
1968,18,G Venkateswaran (LUX),2019-2019,3,3,0,0,0,0,0,0,0.0
1969,19,JK Vifah (Ghana),2019-2019,3,3,0,0,0,0,0,0,0.0
1970,20,V Vijh (LUX),2019-2019,4,4,0,0,0,0,0,0,0.0
1971,21,Vikramjit Singh (NL),2019-2019,1,1,0,0,0,0,0,0,0.0
1972,22,DJ Vilas (SA),2012-2012,1,1,0,0,0,0,0,0,0.0
1973,23,TC Vine (ESP),2019-2019,6,6,0,0,0,0,0,0,0.0
1974,24,R Vishwanath (LUX),2019-2019,2,2,0,0,0,0,0,0,0.0
1975,25,C Vorster (GUE),2019-2019,1,1,0,0,0,0,0,0,0.0
1976,26,Walid Ghauri (NOR),2019-2019,4,4,0,0,0,0,0,0,0.0
1977,27,T Wangchuk jnr (BHU),2019-2019,2,2,0,0,0,0,0,0,0.0
1978,28,S Waqas Ahmed (NOR),2019-2019,5,5,0,0,0,0,0,0,0.0
1979,29,Waqas Khan (HKG),2014-2017,8,8,0,0,0,0,0,0,0.0
1980,30,Waqas Maqsood (PAK),2018-2018,1,1,0,0,0,0,0,0,0.0
1981,31,Waqas Raja (Fin),2019-2019,1,1,0,0,0,0,0,0,0.0
1982,32,I Wardlaw (SCOT),2013-2013,4,4,0,0,0,0,0,0,0.0
1983,33,Wasim Ali (OMAN),2019-2019,1,1,0,0,0,0,0,0,0.0
1984,34,SMK Waththage (CZK-R),2019-2019,5,5,0,0,0,0,0,0,0.0
1985,35,UWMBCA Welegedara (SL),2010-2010,2,2,0,0,0,0,0,0,0.0
1986,36,T Whiteman (LUX),2019-2019,4,4,0,0,0,0,0,0,0.0
1987,37,SG Whittingham (SCOT),2018-2018,3,3,0,0,0,0,0,0,0.0
1988,38,G Wijekoon (SL),2007-2007,3,3,0,0,0,0,0,0,0.0
1989,39,JW Wilson (NZ),2005-2005,1,1,0,0,0,0,0,0,0.0
1990,40,MA Wood (ENG),2015-2019,5,5,0,0,0,0,0,0,0.0
1991,41,Yamin Ahmadzai (AFG),2015-2015,2,2,0,0,0,0,0,0,0.0
1992,42,N Yordanov (),2019-2019,2,2,0,0,0,0,0,0,0.0
1993,43,Zain ul Tashnam (CRC),2019-2019,3,3,0,0,0,0,0,0,0.0
1994,44,Zakir Hasan (BDESH),2018-2018,1,1,0,0,0,0,0,0,0.0
1995,45,Zaki Ul Hassan (Belg),2019-2019,3,3,0,0,0,0,0,0,0.0
1996,46,Zamir Khan (AFG),2012-2012,1,1,0,0,0,0,0,0,0.0
1997,47,S Zargar (Mex),2019-2019,1,1,0,0,0,0,0,0,0.0
1998,48,Zeeshan Siddiqui (OMAN),2015-2015,5,5,0,0,0,0,0,0,0.0
1999,49,Zeshan Arif (Aut),2019-2019,4,4,0,0,0,0,0,0,0.0
2000,0,Ziaur Rahman (AFG),2019-2019,1,1,0,0,0,0,0,0,0.000
2001,1,Ziaur Rehman (Fin),2019-2019,1,1,0,0,0,0,0,0,0.000
2002,2,Zohaib Sarwar (PORT),2019-2019,4,4,0,0,0,0,0,0,0.000
2003,3,M Zondeki (SA),2006-2006,1,1,0,0,0,0,0,0,0.000
2004,4,GMC Mol (NL),2008-2008,1,-,-,-,-,-,-,-,-
2005,5,JD Schoonheim (NL),2008-2008,1,-,-,-,-,-,-,-,-
